year, month,date,carrier,carrier_name,airport,airport_name,arr_flights,arr_del15,arr_on_time
2003,6,2003-06,AA,American Airlines Inc.,SAN,"San Diego, CA: San Diego International",617,115,502
2003,6,2003-06,AS,Alaska Airlines Inc.,SAN,"San Diego, CA: San Diego International",373,60,313
2003,6,2003-06,B6,JetBlue Airways,SAN,"San Diego, CA: San Diego International",5,0,5
2003,6,2003-06,CO,Continental Air Lines Inc.,SAN,"San Diego, CA: San Diego International",256,52,204
2003,6,2003-06,DL,Delta Air Lines Inc.,SAN,"San Diego, CA: San Diego International",446,119,327
2003,6,2003-06,HP,America West Airlines Inc.,SAN,"San Diego, CA: San Diego International",360,38,322
2003,6,2003-06,MQ,American Eagle Airlines Inc.,SAN,"San Diego, CA: San Diego International",802,107,695
2003,6,2003-06,NW,Northwest Airlines Inc.,SAN,"San Diego, CA: San Diego International",210,53,157
2003,6,2003-06,OO,SkyWest Airlines Inc.,SAN,"San Diego, CA: San Diego International",625,27,598
2003,6,2003-06,UA,United Air Lines Inc.,SAN,"San Diego, CA: San Diego International",658,104,554
2003,6,2003-06,US,US Airways Inc.,SAN,"San Diego, CA: San Diego International",192,79,113
2003,6,2003-06,WN,Southwest Airlines Co.,SAN,"San Diego, CA: San Diego International",2307,298,2009
2003,7,2003-07,AA,American Airlines Inc.,SAN,"San Diego, CA: San Diego International",636,113,523
2003,7,2003-07,AS,Alaska Airlines Inc.,SAN,"San Diego, CA: San Diego International",395,91,304
2003,7,2003-07,B6,JetBlue Airways,SAN,"San Diego, CA: San Diego International",49,6,43
2003,7,2003-07,CO,Continental Air Lines Inc.,SAN,"San Diego, CA: San Diego International",273,51,222
2003,7,2003-07,DL,Delta Air Lines Inc.,SAN,"San Diego, CA: San Diego International",446,62,384
2003,7,2003-07,HP,America West Airlines Inc.,SAN,"San Diego, CA: San Diego International",372,57,315
2003,7,2003-07,MQ,American Eagle Airlines Inc.,SAN,"San Diego, CA: San Diego International",855,104,751
2003,7,2003-07,NW,Northwest Airlines Inc.,SAN,"San Diego, CA: San Diego International",217,39,178
2003,7,2003-07,OO,SkyWest Airlines Inc.,SAN,"San Diego, CA: San Diego International",632,53,579
2003,7,2003-07,UA,United Air Lines Inc.,SAN,"San Diego, CA: San Diego International",696,120,576
2003,7,2003-07,US,US Airways Inc.,SAN,"San Diego, CA: San Diego International",211,78,133
2003,7,2003-07,WN,Southwest Airlines Co.,SAN,"San Diego, CA: San Diego International",2395,381,2014
2003,8,2003-08,AA,American Airlines Inc.,SAN,"San Diego, CA: San Diego International",637,119,518
2003,8,2003-08,AS,Alaska Airlines Inc.,SAN,"San Diego, CA: San Diego International",392,99,293
2003,8,2003-08,B6,JetBlue Airways,SAN,"San Diego, CA: San Diego International",62,11,51
2003,8,2003-08,CO,Continental Air Lines Inc.,SAN,"San Diego, CA: San Diego International",268,45,223
2003,8,2003-08,DL,Delta Air Lines Inc.,SAN,"San Diego, CA: San Diego International",460,81,379
2003,8,2003-08,HP,America West Airlines Inc.,SAN,"San Diego, CA: San Diego International",372,62,310
2003,8,2003-08,MQ,American Eagle Airlines Inc.,SAN,"San Diego, CA: San Diego International",856,63,793
2003,8,2003-08,NW,Northwest Airlines Inc.,SAN,"San Diego, CA: San Diego International",217,38,179
2003,8,2003-08,OO,SkyWest Airlines Inc.,SAN,"San Diego, CA: San Diego International",630,33,597
2003,8,2003-08,UA,United Air Lines Inc.,SAN,"San Diego, CA: San Diego International",691,118,573
2003,8,2003-08,US,US Airways Inc.,SAN,"San Diego, CA: San Diego International",211,66,145
2003,8,2003-08,WN,Southwest Airlines Co.,SAN,"San Diego, CA: San Diego International",2403,327,2076
2003,9,2003-09,AA,American Airlines Inc.,SAN,"San Diego, CA: San Diego International",610,51,559
2003,9,2003-09,AS,Alaska Airlines Inc.,SAN,"San Diego, CA: San Diego International",354,29,325
2003,9,2003-09,B6,JetBlue Airways,SAN,"San Diego, CA: San Diego International",88,6,82
2003,9,2003-09,CO,Continental Air Lines Inc.,SAN,"San Diego, CA: San Diego International",229,33,196
2003,9,2003-09,DL,Delta Air Lines Inc.,SAN,"San Diego, CA: San Diego International",445,69,376
2003,9,2003-09,HP,America West Airlines Inc.,SAN,"San Diego, CA: San Diego International",330,46,284
2003,9,2003-09,MQ,American Eagle Airlines Inc.,SAN,"San Diego, CA: San Diego International",878,50,828
2003,9,2003-09,NW,Northwest Airlines Inc.,SAN,"San Diego, CA: San Diego International",181,25,156
2003,9,2003-09,OO,SkyWest Airlines Inc.,SAN,"San Diego, CA: San Diego International",619,31,588
2003,9,2003-09,UA,United Air Lines Inc.,SAN,"San Diego, CA: San Diego International",622,43,579
2003,9,2003-09,US,US Airways Inc.,SAN,"San Diego, CA: San Diego International",175,23,152
2003,9,2003-09,WN,Southwest Airlines Co.,SAN,"San Diego, CA: San Diego International",2357,178,2179
2003,10,2003-10,AA,American Airlines Inc.,SAN,"San Diego, CA: San Diego International",662,59,603
2003,10,2003-10,AS,Alaska Airlines Inc.,SAN,"San Diego, CA: San Diego International",353,64,289
2003,10,2003-10,B6,JetBlue Airways,SAN,"San Diego, CA: San Diego International",93,1,92
2003,10,2003-10,CO,Continental Air Lines Inc.,SAN,"San Diego, CA: San Diego International",235,20,215
2003,10,2003-10,DL,Delta Air Lines Inc.,SAN,"San Diego, CA: San Diego International",459,58,401
2003,10,2003-10,HP,America West Airlines Inc.,SAN,"San Diego, CA: San Diego International",337,45,292
2003,10,2003-10,MQ,American Eagle Airlines Inc.,SAN,"San Diego, CA: San Diego International",945,104,841
2003,10,2003-10,NW,Northwest Airlines Inc.,SAN,"San Diego, CA: San Diego International",186,34,152
2003,10,2003-10,OO,SkyWest Airlines Inc.,SAN,"San Diego, CA: San Diego International",640,72,568
2003,10,2003-10,UA,United Air Lines Inc.,SAN,"San Diego, CA: San Diego International",639,105,534
2003,10,2003-10,US,US Airways Inc.,SAN,"San Diego, CA: San Diego International",175,22,153
2003,10,2003-10,WN,Southwest Airlines Co.,SAN,"San Diego, CA: San Diego International",2482,308,2174
2003,11,2003-11,AA,American Airlines Inc.,SAN,"San Diego, CA: San Diego International",584,163,421
2003,11,2003-11,AS,Alaska Airlines Inc.,SAN,"San Diego, CA: San Diego International",312,51,261
2003,11,2003-11,B6,JetBlue Airways,SAN,"San Diego, CA: San Diego International",89,21,68
2003,11,2003-11,CO,Continental Air Lines Inc.,SAN,"San Diego, CA: San Diego International",226,55,171
2003,11,2003-11,DL,Delta Air Lines Inc.,SAN,"San Diego, CA: San Diego International",446,114,332
2003,11,2003-11,HA,Hawaiian Airlines Inc.,SAN,"San Diego, CA: San Diego International",30,3,27
2003,11,2003-11,HP,America West Airlines Inc.,SAN,"San Diego, CA: San Diego International",321,60,261
2003,11,2003-11,MQ,American Eagle Airlines Inc.,SAN,"San Diego, CA: San Diego International",851,66,785
2003,11,2003-11,NW,Northwest Airlines Inc.,SAN,"San Diego, CA: San Diego International",178,98,80
2003,11,2003-11,OO,SkyWest Airlines Inc.,SAN,"San Diego, CA: San Diego International",620,40,580
2003,11,2003-11,UA,United Air Lines Inc.,SAN,"San Diego, CA: San Diego International",619,184,435
2003,11,2003-11,US,US Airways Inc.,SAN,"San Diego, CA: San Diego International",162,38,124
2003,11,2003-11,WN,Southwest Airlines Co.,SAN,"San Diego, CA: San Diego International",2347,388,1959
2003,12,2003-12,AA,American Airlines Inc.,SAN,"San Diego, CA: San Diego International",610,199,411
2003,12,2003-12,AS,Alaska Airlines Inc.,SAN,"San Diego, CA: San Diego International",332,74,258
2003,12,2003-12,B6,JetBlue Airways,SAN,"San Diego, CA: San Diego International",93,9,84
2003,12,2003-12,CO,Continental Air Lines Inc.,SAN,"San Diego, CA: San Diego International",239,54,185
2003,12,2003-12,DL,Delta Air Lines Inc.,SAN,"San Diego, CA: San Diego International",455,91,364
2003,12,2003-12,HA,Hawaiian Airlines Inc.,SAN,"San Diego, CA: San Diego International",31,23,8
2003,12,2003-12,HP,America West Airlines Inc.,SAN,"San Diego, CA: San Diego International",333,70,263
2003,12,2003-12,MQ,American Eagle Airlines Inc.,SAN,"San Diego, CA: San Diego International",1016,161,855
2003,12,2003-12,NW,Northwest Airlines Inc.,SAN,"San Diego, CA: San Diego International",186,82,104
2003,12,2003-12,OO,SkyWest Airlines Inc.,SAN,"San Diego, CA: San Diego International",626,81,545
2003,12,2003-12,UA,United Air Lines Inc.,SAN,"San Diego, CA: San Diego International",648,183,465
2003,12,2003-12,US,US Airways Inc.,SAN,"San Diego, CA: San Diego International",163,40,123
2003,12,2003-12,WN,Southwest Airlines Co.,SAN,"San Diego, CA: San Diego International",2416,482,1934
2004,1,2004-01,AA,American Airlines Inc.,SAN,"San Diego, CA: San Diego International",585,188,397
2004,1,2004-01,AS,Alaska Airlines Inc.,SAN,"San Diego, CA: San Diego International",319,60,259
2004,1,2004-01,B6,JetBlue Airways,SAN,"San Diego, CA: San Diego International",93,17,76
2004,1,2004-01,CO,Continental Air Lines Inc.,SAN,"San Diego, CA: San Diego International",235,51,184
2004,1,2004-01,DL,Delta Air Lines Inc.,SAN,"San Diego, CA: San Diego International",432,88,344
2004,1,2004-01,HA,Hawaiian Airlines Inc.,SAN,"San Diego, CA: San Diego International",30,14,16
2004,1,2004-01,HP,America West Airlines Inc.,SAN,"San Diego, CA: San Diego International",361,72,289
2004,1,2004-01,MQ,American Eagle Airlines Inc.,SAN,"San Diego, CA: San Diego International",1015,72,943
2004,1,2004-01,NW,Northwest Airlines Inc.,SAN,"San Diego, CA: San Diego International",191,68,123
2004,1,2004-01,OO,SkyWest Airlines Inc.,SAN,"San Diego, CA: San Diego International",653,38,615
2004,1,2004-01,UA,United Air Lines Inc.,SAN,"San Diego, CA: San Diego International",652,158,494
2004,1,2004-01,US,US Airways Inc.,SAN,"San Diego, CA: San Diego International",167,52,115
2004,1,2004-01,WN,Southwest Airlines Co.,SAN,"San Diego, CA: San Diego International",2443,364,2079
2004,2,2004-02,AA,American Airlines Inc.,SAN,"San Diego, CA: San Diego International",542,121,421
2004,2,2004-02,AS,Alaska Airlines Inc.,SAN,"San Diego, CA: San Diego International",300,50,250
2004,2,2004-02,B6,JetBlue Airways,SAN,"San Diego, CA: San Diego International",87,2,85
2004,2,2004-02,CO,Continental Air Lines Inc.,SAN,"San Diego, CA: San Diego International",224,42,182
2004,2,2004-02,DL,Delta Air Lines Inc.,SAN,"San Diego, CA: San Diego International",402,93,309
2004,2,2004-02,HA,Hawaiian Airlines Inc.,SAN,"San Diego, CA: San Diego International",29,6,23
2004,2,2004-02,HP,America West Airlines Inc.,SAN,"San Diego, CA: San Diego International",344,86,258
2004,2,2004-02,MQ,American Eagle Airlines Inc.,SAN,"San Diego, CA: San Diego International",844,95,749
2004,2,2004-02,NW,Northwest Airlines Inc.,SAN,"San Diego, CA: San Diego International",174,42,132
2004,2,2004-02,OO,SkyWest Airlines Inc.,SAN,"San Diego, CA: San Diego International",597,60,537
2004,2,2004-02,UA,United Air Lines Inc.,SAN,"San Diego, CA: San Diego International",605,97,508
2004,2,2004-02,US,US Airways Inc.,SAN,"San Diego, CA: San Diego International",144,21,123
2004,2,2004-02,WN,Southwest Airlines Co.,SAN,"San Diego, CA: San Diego International",2333,385,1948
2004,3,2004-03,AA,American Airlines Inc.,SAN,"San Diego, CA: San Diego International",611,114,497
2004,3,2004-03,AS,Alaska Airlines Inc.,SAN,"San Diego, CA: San Diego International",325,49,276
2004,3,2004-03,B6,JetBlue Airways,SAN,"San Diego, CA: San Diego International",93,10,83
2004,3,2004-03,CO,Continental Air Lines Inc.,SAN,"San Diego, CA: San Diego International",242,39,203
2004,3,2004-03,DL,Delta Air Lines Inc.,SAN,"San Diego, CA: San Diego International",434,48,386
2004,3,2004-03,HA,Hawaiian Airlines Inc.,SAN,"San Diego, CA: San Diego International",31,10,21
2004,3,2004-03,HP,America West Airlines Inc.,SAN,"San Diego, CA: San Diego International",367,96,271
2004,3,2004-03,MQ,American Eagle Airlines Inc.,SAN,"San Diego, CA: San Diego International",904,108,796
2004,3,2004-03,NW,Northwest Airlines Inc.,SAN,"San Diego, CA: San Diego International",186,46,140
2004,3,2004-03,OO,SkyWest Airlines Inc.,SAN,"San Diego, CA: San Diego International",633,62,571
2004,3,2004-03,UA,United Air Lines Inc.,SAN,"San Diego, CA: San Diego International",725,86,639
2004,3,2004-03,US,US Airways Inc.,SAN,"San Diego, CA: San Diego International",151,27,124
2004,3,2004-03,WN,Southwest Airlines Co.,SAN,"San Diego, CA: San Diego International",2501,396,2105
2004,4,2004-04,AA,American Airlines Inc.,SAN,"San Diego, CA: San Diego International",615,106,509
2004,4,2004-04,AS,Alaska Airlines Inc.,SAN,"San Diego, CA: San Diego International",321,39,282
2004,4,2004-04,B6,JetBlue Airways,SAN,"San Diego, CA: San Diego International",89,4,85
2004,4,2004-04,CO,Continental Air Lines Inc.,SAN,"San Diego, CA: San Diego International",233,67,166
2004,4,2004-04,DL,Delta Air Lines Inc.,SAN,"San Diego, CA: San Diego International",415,40,375
2004,4,2004-04,HA,Hawaiian Airlines Inc.,SAN,"San Diego, CA: San Diego International",30,10,20
2004,4,2004-04,HP,America West Airlines Inc.,SAN,"San Diego, CA: San Diego International",326,54,272
2004,4,2004-04,MQ,American Eagle Airlines Inc.,SAN,"San Diego, CA: San Diego International",920,115,805
2004,4,2004-04,NW,Northwest Airlines Inc.,SAN,"San Diego, CA: San Diego International",180,39,141
2004,4,2004-04,OO,SkyWest Airlines Inc.,SAN,"San Diego, CA: San Diego International",606,55,551
2004,4,2004-04,UA,United Air Lines Inc.,SAN,"San Diego, CA: San Diego International",662,74,588
2004,4,2004-04,US,US Airways Inc.,SAN,"San Diego, CA: San Diego International",146,23,123
2004,4,2004-04,WN,Southwest Airlines Co.,SAN,"San Diego, CA: San Diego International",2414,393,2021
2004,5,2004-05,AA,American Airlines Inc.,SAN,"San Diego, CA: San Diego International",635,126,509
2004,5,2004-05,AS,Alaska Airlines Inc.,SAN,"San Diego, CA: San Diego International",367,50,317
2004,5,2004-05,B6,JetBlue Airways,SAN,"San Diego, CA: San Diego International",93,19,74
2004,5,2004-05,CO,Continental Air Lines Inc.,SAN,"San Diego, CA: San Diego International",239,58,181
2004,5,2004-05,DL,Delta Air Lines Inc.,SAN,"San Diego, CA: San Diego International",427,59,368
2004,5,2004-05,HA,Hawaiian Airlines Inc.,SAN,"San Diego, CA: San Diego International",31,5,26
2004,5,2004-05,HP,America West Airlines Inc.,SAN,"San Diego, CA: San Diego International",333,46,287
2004,5,2004-05,MQ,American Eagle Airlines Inc.,SAN,"San Diego, CA: San Diego International",953,71,882
2004,5,2004-05,NW,Northwest Airlines Inc.,SAN,"San Diego, CA: San Diego International",186,68,118
2004,5,2004-05,OO,SkyWest Airlines Inc.,SAN,"San Diego, CA: San Diego International",653,46,607
2004,5,2004-05,UA,United Air Lines Inc.,SAN,"San Diego, CA: San Diego International",689,168,521
2004,5,2004-05,US,US Airways Inc.,SAN,"San Diego, CA: San Diego International",176,46,130
2004,5,2004-05,WN,Southwest Airlines Co.,SAN,"San Diego, CA: San Diego International",2462,418,2044
2004,6,2004-06,AA,American Airlines Inc.,SAN,"San Diego, CA: San Diego International",624,176,448
2004,6,2004-06,AS,Alaska Airlines Inc.,SAN,"San Diego, CA: San Diego International",385,104,281
2004,6,2004-06,B6,JetBlue Airways,SAN,"San Diego, CA: San Diego International",90,15,75
2004,6,2004-06,CO,Continental Air Lines Inc.,SAN,"San Diego, CA: San Diego International",248,93,155
2004,6,2004-06,DL,Delta Air Lines Inc.,SAN,"San Diego, CA: San Diego International",418,126,292
2004,6,2004-06,HA,Hawaiian Airlines Inc.,SAN,"San Diego, CA: San Diego International",50,2,48
2004,6,2004-06,HP,America West Airlines Inc.,SAN,"San Diego, CA: San Diego International",326,85,241
2004,6,2004-06,MQ,American Eagle Airlines Inc.,SAN,"San Diego, CA: San Diego International",838,106,732
2004,6,2004-06,NW,Northwest Airlines Inc.,SAN,"San Diego, CA: San Diego International",201,89,112
2004,6,2004-06,OO,SkyWest Airlines Inc.,SAN,"San Diego, CA: San Diego International",632,51,581
2004,6,2004-06,UA,United Air Lines Inc.,SAN,"San Diego, CA: San Diego International",737,136,601
2004,6,2004-06,US,US Airways Inc.,SAN,"San Diego, CA: San Diego International",175,72,103
2004,6,2004-06,WN,Southwest Airlines Co.,SAN,"San Diego, CA: San Diego International",2408,559,1849
2004,7,2004-07,AA,American Airlines Inc.,SAN,"San Diego, CA: San Diego International",638,170,468
2004,7,2004-07,AS,Alaska Airlines Inc.,SAN,"San Diego, CA: San Diego International",401,89,312
2004,7,2004-07,B6,JetBlue Airways,SAN,"San Diego, CA: San Diego International",93,15,78
2004,7,2004-07,CO,Continental Air Lines Inc.,SAN,"San Diego, CA: San Diego International",256,56,200
2004,7,2004-07,DL,Delta Air Lines Inc.,SAN,"San Diego, CA: San Diego International",484,125,359
2004,7,2004-07,HA,Hawaiian Airlines Inc.,SAN,"San Diego, CA: San Diego International",62,4,58
2004,7,2004-07,HP,America West Airlines Inc.,SAN,"San Diego, CA: San Diego International",334,77,257
2004,7,2004-07,MQ,American Eagle Airlines Inc.,SAN,"San Diego, CA: San Diego International",888,129,759
2004,7,2004-07,NW,Northwest Airlines Inc.,SAN,"San Diego, CA: San Diego International",217,72,145
2004,7,2004-07,OO,SkyWest Airlines Inc.,SAN,"San Diego, CA: San Diego International",640,55,585
2004,7,2004-07,UA,United Air Lines Inc.,SAN,"San Diego, CA: San Diego International",766,142,624
2004,7,2004-07,US,US Airways Inc.,SAN,"San Diego, CA: San Diego International",178,69,109
2004,7,2004-07,WN,Southwest Airlines Co.,SAN,"San Diego, CA: San Diego International",2460,581,1879
2004,8,2004-08,AA,American Airlines Inc.,SAN,"San Diego, CA: San Diego International",647,176,471
2004,8,2004-08,AS,Alaska Airlines Inc.,SAN,"San Diego, CA: San Diego International",403,102,301
2004,8,2004-08,B6,JetBlue Airways,SAN,"San Diego, CA: San Diego International",93,18,75
2004,8,2004-08,CO,Continental Air Lines Inc.,SAN,"San Diego, CA: San Diego International",247,56,191
2004,8,2004-08,DL,Delta Air Lines Inc.,SAN,"San Diego, CA: San Diego International",487,115,372
2004,8,2004-08,HA,Hawaiian Airlines Inc.,SAN,"San Diego, CA: San Diego International",62,5,57
2004,8,2004-08,HP,America West Airlines Inc.,SAN,"San Diego, CA: San Diego International",337,74,263
2004,8,2004-08,MQ,American Eagle Airlines Inc.,SAN,"San Diego, CA: San Diego International",897,98,799
2004,8,2004-08,NW,Northwest Airlines Inc.,SAN,"San Diego, CA: San Diego International",216,65,151
2004,8,2004-08,OO,SkyWest Airlines Inc.,SAN,"San Diego, CA: San Diego International",698,56,642
2004,8,2004-08,UA,United Air Lines Inc.,SAN,"San Diego, CA: San Diego International",776,148,628
2004,8,2004-08,US,US Airways Inc.,SAN,"San Diego, CA: San Diego International",181,66,115
2004,8,2004-08,WN,Southwest Airlines Co.,SAN,"San Diego, CA: San Diego International",2486,664,1822
2004,9,2004-09,AA,American Airlines Inc.,SAN,"San Diego, CA: San Diego International",587,57,530
2004,9,2004-09,AS,Alaska Airlines Inc.,SAN,"San Diego, CA: San Diego International",368,50,318
2004,9,2004-09,B6,JetBlue Airways,SAN,"San Diego, CA: San Diego International",67,3,64
2004,9,2004-09,CO,Continental Air Lines Inc.,SAN,"San Diego, CA: San Diego International",227,17,210
2004,9,2004-09,DL,Delta Air Lines Inc.,SAN,"San Diego, CA: San Diego International",474,80,394
2004,9,2004-09,HA,Hawaiian Airlines Inc.,SAN,"San Diego, CA: San Diego International",36,4,32
2004,9,2004-09,HP,America West Airlines Inc.,SAN,"San Diego, CA: San Diego International",329,56,273
2004,9,2004-09,MQ,American Eagle Airlines Inc.,SAN,"San Diego, CA: San Diego International",884,69,815
2004,9,2004-09,NW,Northwest Airlines Inc.,SAN,"San Diego, CA: San Diego International",150,36,114
2004,9,2004-09,OO,SkyWest Airlines Inc.,SAN,"San Diego, CA: San Diego International",682,57,625
2004,9,2004-09,UA,United Air Lines Inc.,SAN,"San Diego, CA: San Diego International",691,79,612
2004,9,2004-09,US,US Airways Inc.,SAN,"San Diego, CA: San Diego International",151,23,128
2004,9,2004-09,WN,Southwest Airlines Co.,SAN,"San Diego, CA: San Diego International",2441,354,2087
2004,10,2004-10,AA,American Airlines Inc.,SAN,"San Diego, CA: San Diego International",600,158,442
2004,10,2004-10,AS,Alaska Airlines Inc.,SAN,"San Diego, CA: San Diego International",367,80,287
2004,10,2004-10,B6,JetBlue Airways,SAN,"San Diego, CA: San Diego International",62,25,37
2004,10,2004-10,CO,Continental Air Lines Inc.,SAN,"San Diego, CA: San Diego International",240,49,191
2004,10,2004-10,DL,Delta Air Lines Inc.,SAN,"San Diego, CA: San Diego International",488,115,373
2004,10,2004-10,HA,Hawaiian Airlines Inc.,SAN,"San Diego, CA: San Diego International",31,3,28
2004,10,2004-10,HP,America West Airlines Inc.,SAN,"San Diego, CA: San Diego International",333,68,265
2004,10,2004-10,MQ,American Eagle Airlines Inc.,SAN,"San Diego, CA: San Diego International",904,90,814
2004,10,2004-10,NW,Northwest Airlines Inc.,SAN,"San Diego, CA: San Diego International",186,81,105
2004,10,2004-10,OO,SkyWest Airlines Inc.,SAN,"San Diego, CA: San Diego International",697,98,599
2004,10,2004-10,UA,United Air Lines Inc.,SAN,"San Diego, CA: San Diego International",697,146,551
2004,10,2004-10,US,US Airways Inc.,SAN,"San Diego, CA: San Diego International",179,70,109
2004,10,2004-10,WN,Southwest Airlines Co.,SAN,"San Diego, CA: San Diego International",2540,693,1847
2004,11,2004-11,AA,American Airlines Inc.,SAN,"San Diego, CA: San Diego International",581,110,471
2004,11,2004-11,AS,Alaska Airlines Inc.,SAN,"San Diego, CA: San Diego International",340,89,251
2004,11,2004-11,B6,JetBlue Airways,SAN,"San Diego, CA: San Diego International",59,7,52
2004,11,2004-11,CO,Continental Air Lines Inc.,SAN,"San Diego, CA: San Diego International",238,59,179
2004,11,2004-11,DL,Delta Air Lines Inc.,SAN,"San Diego, CA: San Diego International",466,84,382
2004,11,2004-11,HA,Hawaiian Airlines Inc.,SAN,"San Diego, CA: San Diego International",30,6,24
2004,11,2004-11,HP,America West Airlines Inc.,SAN,"San Diego, CA: San Diego International",328,76,252
2004,11,2004-11,MQ,American Eagle Airlines Inc.,SAN,"San Diego, CA: San Diego International",891,80,811
2004,11,2004-11,NW,Northwest Airlines Inc.,SAN,"San Diego, CA: San Diego International",178,32,146
2004,11,2004-11,OO,SkyWest Airlines Inc.,SAN,"San Diego, CA: San Diego International",669,67,602
2004,11,2004-11,UA,United Air Lines Inc.,SAN,"San Diego, CA: San Diego International",672,78,594
2004,11,2004-11,US,US Airways Inc.,SAN,"San Diego, CA: San Diego International",151,40,111
2004,11,2004-11,WN,Southwest Airlines Co.,SAN,"San Diego, CA: San Diego International",2453,471,1982
2004,12,2004-12,AA,American Airlines Inc.,SAN,"San Diego, CA: San Diego International",608,171,437
2004,12,2004-12,AS,Alaska Airlines Inc.,SAN,"San Diego, CA: San Diego International",356,137,219
2004,12,2004-12,B6,JetBlue Airways,SAN,"San Diego, CA: San Diego International",60,17,43
2004,12,2004-12,CO,Continental Air Lines Inc.,SAN,"San Diego, CA: San Diego International",260,70,190
2004,12,2004-12,DL,Delta Air Lines Inc.,SAN,"San Diego, CA: San Diego International",461,123,338
2004,12,2004-12,HA,Hawaiian Airlines Inc.,SAN,"San Diego, CA: San Diego International",31,9,22
2004,12,2004-12,HP,America West Airlines Inc.,SAN,"San Diego, CA: San Diego International",338,92,246
2004,12,2004-12,MQ,American Eagle Airlines Inc.,SAN,"San Diego, CA: San Diego International",919,126,793
2004,12,2004-12,NW,Northwest Airlines Inc.,SAN,"San Diego, CA: San Diego International",189,84,105
2004,12,2004-12,OO,SkyWest Airlines Inc.,SAN,"San Diego, CA: San Diego International",688,131,557
2004,12,2004-12,UA,United Air Lines Inc.,SAN,"San Diego, CA: San Diego International",695,146,549
2004,12,2004-12,US,US Airways Inc.,SAN,"San Diego, CA: San Diego International",149,67,82
2004,12,2004-12,WN,Southwest Airlines Co.,SAN,"San Diego, CA: San Diego International",2576,766,1810
2005,1,2005-01,AA,American Airlines Inc.,SAN,"San Diego, CA: San Diego International",604,210,394
2005,1,2005-01,AS,Alaska Airlines Inc.,SAN,"San Diego, CA: San Diego International",343,119,224
2005,1,2005-01,B6,JetBlue Airways,SAN,"San Diego, CA: San Diego International",62,22,40
2005,1,2005-01,CO,Continental Air Lines Inc.,SAN,"San Diego, CA: San Diego International",238,80,158
2005,1,2005-01,DL,Delta Air Lines Inc.,SAN,"San Diego, CA: San Diego International",454,153,301
2005,1,2005-01,HA,Hawaiian Airlines Inc.,SAN,"San Diego, CA: San Diego International",31,5,26
2005,1,2005-01,HP,America West Airlines Inc.,SAN,"San Diego, CA: San Diego International",368,97,271
2005,1,2005-01,MQ,American Eagle Airlines Inc.,SAN,"San Diego, CA: San Diego International",904,96,808
2005,1,2005-01,NW,Northwest Airlines Inc.,SAN,"San Diego, CA: San Diego International",189,88,101
2005,1,2005-01,OO,SkyWest Airlines Inc.,SAN,"San Diego, CA: San Diego International",693,140,553
2005,1,2005-01,UA,United Air Lines Inc.,SAN,"San Diego, CA: San Diego International",696,216,480
2005,1,2005-01,US,US Airways Inc.,SAN,"San Diego, CA: San Diego International",148,76,72
2005,1,2005-01,WN,Southwest Airlines Co.,SAN,"San Diego, CA: San Diego International",2553,650,1903
2005,2,2005-02,AA,American Airlines Inc.,SAN,"San Diego, CA: San Diego International",543,130,413
2005,2,2005-02,AS,Alaska Airlines Inc.,SAN,"San Diego, CA: San Diego International",307,98,209
2005,2,2005-02,B6,JetBlue Airways,SAN,"San Diego, CA: San Diego International",56,20,36
2005,2,2005-02,CO,Continental Air Lines Inc.,SAN,"San Diego, CA: San Diego International",229,76,153
2005,2,2005-02,DL,Delta Air Lines Inc.,SAN,"San Diego, CA: San Diego International",392,128,264
2005,2,2005-02,HA,Hawaiian Airlines Inc.,SAN,"San Diego, CA: San Diego International",28,5,23
2005,2,2005-02,HP,America West Airlines Inc.,SAN,"San Diego, CA: San Diego International",334,90,244
2005,2,2005-02,MQ,American Eagle Airlines Inc.,SAN,"San Diego, CA: San Diego International",806,108,698
2005,2,2005-02,NW,Northwest Airlines Inc.,SAN,"San Diego, CA: San Diego International",168,83,85
2005,2,2005-02,OO,SkyWest Airlines Inc.,SAN,"San Diego, CA: San Diego International",602,94,508
2005,2,2005-02,UA,United Air Lines Inc.,SAN,"San Diego, CA: San Diego International",617,169,448
2005,2,2005-02,US,US Airways Inc.,SAN,"San Diego, CA: San Diego International",157,58,99
2005,2,2005-02,WN,Southwest Airlines Co.,SAN,"San Diego, CA: San Diego International",2304,576,1728
2005,3,2005-03,AA,American Airlines Inc.,SAN,"San Diego, CA: San Diego International",608,101,507
2005,3,2005-03,AS,Alaska Airlines Inc.,SAN,"San Diego, CA: San Diego International",340,79,261
2005,3,2005-03,B6,JetBlue Airways,SAN,"San Diego, CA: San Diego International",62,12,50
2005,3,2005-03,CO,Continental Air Lines Inc.,SAN,"San Diego, CA: San Diego International",282,86,196
2005,3,2005-03,DL,Delta Air Lines Inc.,SAN,"San Diego, CA: San Diego International",434,81,353
2005,3,2005-03,HA,Hawaiian Airlines Inc.,SAN,"San Diego, CA: San Diego International",31,5,26
2005,3,2005-03,HP,America West Airlines Inc.,SAN,"San Diego, CA: San Diego International",372,61,311
2005,3,2005-03,MQ,American Eagle Airlines Inc.,SAN,"San Diego, CA: San Diego International",897,112,785
2005,3,2005-03,NW,Northwest Airlines Inc.,SAN,"San Diego, CA: San Diego International",186,45,141
2005,3,2005-03,OO,SkyWest Airlines Inc.,SAN,"San Diego, CA: San Diego International",673,78,595
2005,3,2005-03,UA,United Air Lines Inc.,SAN,"San Diego, CA: San Diego International",672,121,551
2005,3,2005-03,US,US Airways Inc.,SAN,"San Diego, CA: San Diego International",182,44,138
2005,3,2005-03,WN,Southwest Airlines Co.,SAN,"San Diego, CA: San Diego International",2559,499,2060
2005,4,2005-04,AA,American Airlines Inc.,SAN,"San Diego, CA: San Diego International",617,122,495
2005,4,2005-04,AS,Alaska Airlines Inc.,SAN,"San Diego, CA: San Diego International",330,87,243
2005,4,2005-04,B6,JetBlue Airways,SAN,"San Diego, CA: San Diego International",60,15,45
2005,4,2005-04,CO,Continental Air Lines Inc.,SAN,"San Diego, CA: San Diego International",270,69,201
2005,4,2005-04,DH,Independence Air,SAN,"San Diego, CA: San Diego International",17,8,9
2005,4,2005-04,DL,Delta Air Lines Inc.,SAN,"San Diego, CA: San Diego International",363,74,289
2005,4,2005-04,HA,Hawaiian Airlines Inc.,SAN,"San Diego, CA: San Diego International",30,4,26
2005,4,2005-04,HP,America West Airlines Inc.,SAN,"San Diego, CA: San Diego International",360,67,293
2005,4,2005-04,MQ,American Eagle Airlines Inc.,SAN,"San Diego, CA: San Diego International",863,64,799
2005,4,2005-04,NW,Northwest Airlines Inc.,SAN,"San Diego, CA: San Diego International",180,25,155
2005,4,2005-04,OO,SkyWest Airlines Inc.,SAN,"San Diego, CA: San Diego International",710,47,663
2005,4,2005-04,UA,United Air Lines Inc.,SAN,"San Diego, CA: San Diego International",650,90,560
2005,4,2005-04,US,US Airways Inc.,SAN,"San Diego, CA: San Diego International",175,43,132
2005,4,2005-04,WN,Southwest Airlines Co.,SAN,"San Diego, CA: San Diego International",2466,380,2086
2005,5,2005-05,AA,American Airlines Inc.,SAN,"San Diego, CA: San Diego International",643,92,551
2005,5,2005-05,AS,Alaska Airlines Inc.,SAN,"San Diego, CA: San Diego International",344,133,211
2005,5,2005-05,B6,JetBlue Airways,SAN,"San Diego, CA: San Diego International",91,29,62
2005,5,2005-05,CO,Continental Air Lines Inc.,SAN,"San Diego, CA: San Diego International",270,45,225
2005,5,2005-05,DH,Independence Air,SAN,"San Diego, CA: San Diego International",31,8,23
2005,5,2005-05,DL,Delta Air Lines Inc.,SAN,"San Diego, CA: San Diego International",341,35,306
2005,5,2005-05,EV,Atlantic Southeast Airlines,SAN,"San Diego, CA: San Diego International",24,4,20
2005,5,2005-05,F9,Frontier Airlines Inc.,SAN,"San Diego, CA: San Diego International",144,25,119
2005,5,2005-05,HA,Hawaiian Airlines Inc.,SAN,"San Diego, CA: San Diego International",31,7,24
2005,5,2005-05,HP,America West Airlines Inc.,SAN,"San Diego, CA: San Diego International",372,51,321
2005,5,2005-05,MQ,American Eagle Airlines Inc.,SAN,"San Diego, CA: San Diego International",893,72,821
2005,5,2005-05,NW,Northwest Airlines Inc.,SAN,"San Diego, CA: San Diego International",186,39,147
2005,5,2005-05,OO,SkyWest Airlines Inc.,SAN,"San Diego, CA: San Diego International",741,84,657
2005,5,2005-05,UA,United Air Lines Inc.,SAN,"San Diego, CA: San Diego International",672,123,549
2005,5,2005-05,US,US Airways Inc.,SAN,"San Diego, CA: San Diego International",181,30,151
2005,5,2005-05,WN,Southwest Airlines Co.,SAN,"San Diego, CA: San Diego International",2548,340,2208
2005,6,2005-06,AA,American Airlines Inc.,SAN,"San Diego, CA: San Diego International",628,199,429
2005,6,2005-06,AS,Alaska Airlines Inc.,SAN,"San Diego, CA: San Diego International",330,141,189
2005,6,2005-06,B6,JetBlue Airways,SAN,"San Diego, CA: San Diego International",104,33,71
2005,6,2005-06,CO,Continental Air Lines Inc.,SAN,"San Diego, CA: San Diego International",277,63,214
2005,6,2005-06,DH,Independence Air,SAN,"San Diego, CA: San Diego International",30,13,17
2005,6,2005-06,DL,Delta Air Lines Inc.,SAN,"San Diego, CA: San Diego International",390,91,299
2005,6,2005-06,EV,Atlantic Southeast Airlines,SAN,"San Diego, CA: San Diego International",30,8,22
2005,6,2005-06,F9,Frontier Airlines Inc.,SAN,"San Diego, CA: San Diego International",150,35,115
2005,6,2005-06,HA,Hawaiian Airlines Inc.,SAN,"San Diego, CA: San Diego International",51,10,41
2005,6,2005-06,HP,America West Airlines Inc.,SAN,"San Diego, CA: San Diego International",372,69,303
2005,6,2005-06,MQ,American Eagle Airlines Inc.,SAN,"San Diego, CA: San Diego International",873,86,787
2005,6,2005-06,NW,Northwest Airlines Inc.,SAN,"San Diego, CA: San Diego International",202,85,117
2005,6,2005-06,OO,SkyWest Airlines Inc.,SAN,"San Diego, CA: San Diego International",762,68,694
2005,6,2005-06,UA,United Air Lines Inc.,SAN,"San Diego, CA: San Diego International",702,215,487
2005,6,2005-06,US,US Airways Inc.,SAN,"San Diego, CA: San Diego International",176,75,101
2005,6,2005-06,WN,Southwest Airlines Co.,SAN,"San Diego, CA: San Diego International",2497,470,2027
2005,7,2005-07,AA,American Airlines Inc.,SAN,"San Diego, CA: San Diego International",649,205,444
2005,7,2005-07,AS,Alaska Airlines Inc.,SAN,"San Diego, CA: San Diego International",341,114,227
2005,7,2005-07,B6,JetBlue Airways,SAN,"San Diego, CA: San Diego International",124,32,92
2005,7,2005-07,CO,Continental Air Lines Inc.,SAN,"San Diego, CA: San Diego International",300,77,223
2005,7,2005-07,DH,Independence Air,SAN,"San Diego, CA: San Diego International",31,9,22
2005,7,2005-07,DL,Delta Air Lines Inc.,SAN,"San Diego, CA: San Diego International",403,84,319
2005,7,2005-07,EV,Atlantic Southeast Airlines,SAN,"San Diego, CA: San Diego International",31,11,20
2005,7,2005-07,F9,Frontier Airlines Inc.,SAN,"San Diego, CA: San Diego International",155,20,135
2005,7,2005-07,HA,Hawaiian Airlines Inc.,SAN,"San Diego, CA: San Diego International",62,9,53
2005,7,2005-07,HP,America West Airlines Inc.,SAN,"San Diego, CA: San Diego International",367,100,267
2005,7,2005-07,MQ,American Eagle Airlines Inc.,SAN,"San Diego, CA: San Diego International",887,127,760
2005,7,2005-07,NW,Northwest Airlines Inc.,SAN,"San Diego, CA: San Diego International",217,73,144
2005,7,2005-07,OO,SkyWest Airlines Inc.,SAN,"San Diego, CA: San Diego International",778,103,675
2005,7,2005-07,UA,United Air Lines Inc.,SAN,"San Diego, CA: San Diego International",733,163,570
2005,7,2005-07,US,US Airways Inc.,SAN,"San Diego, CA: San Diego International",180,64,116
2005,7,2005-07,WN,Southwest Airlines Co.,SAN,"San Diego, CA: San Diego International",2604,578,2026
2005,8,2005-08,AA,American Airlines Inc.,SAN,"San Diego, CA: San Diego International",649,179,470
2005,8,2005-08,AS,Alaska Airlines Inc.,SAN,"San Diego, CA: San Diego International",341,85,256
2005,8,2005-08,B6,JetBlue Airways,SAN,"San Diego, CA: San Diego International",124,25,99
2005,8,2005-08,CO,Continental Air Lines Inc.,SAN,"San Diego, CA: San Diego International",305,66,239
2005,8,2005-08,DH,Independence Air,SAN,"San Diego, CA: San Diego International",31,6,25
2005,8,2005-08,DL,Delta Air Lines Inc.,SAN,"San Diego, CA: San Diego International",399,85,314
2005,8,2005-08,EV,Atlantic Southeast Airlines,SAN,"San Diego, CA: San Diego International",31,10,21
2005,8,2005-08,F9,Frontier Airlines Inc.,SAN,"San Diego, CA: San Diego International",155,23,132
2005,8,2005-08,HA,Hawaiian Airlines Inc.,SAN,"San Diego, CA: San Diego International",62,3,59
2005,8,2005-08,HP,America West Airlines Inc.,SAN,"San Diego, CA: San Diego International",368,84,284
2005,8,2005-08,MQ,American Eagle Airlines Inc.,SAN,"San Diego, CA: San Diego International",906,118,788
2005,8,2005-08,NW,Northwest Airlines Inc.,SAN,"San Diego, CA: San Diego International",193,88,105
2005,8,2005-08,OO,SkyWest Airlines Inc.,SAN,"San Diego, CA: San Diego International",802,114,688
2005,8,2005-08,UA,United Air Lines Inc.,SAN,"San Diego, CA: San Diego International",740,152,588
2005,8,2005-08,US,US Airways Inc.,SAN,"San Diego, CA: San Diego International",160,42,118
2005,8,2005-08,WN,Southwest Airlines Co.,SAN,"San Diego, CA: San Diego International",2680,549,2131
2005,9,2005-09,AA,American Airlines Inc.,SAN,"San Diego, CA: San Diego International",620,143,477
2005,9,2005-09,AS,Alaska Airlines Inc.,SAN,"San Diego, CA: San Diego International",350,77,273
2005,9,2005-09,B6,JetBlue Airways,SAN,"San Diego, CA: San Diego International",95,23,72
2005,9,2005-09,CO,Continental Air Lines Inc.,SAN,"San Diego, CA: San Diego International",259,43,216
2005,9,2005-09,DH,Independence Air,SAN,"San Diego, CA: San Diego International",30,5,25
2005,9,2005-09,DL,Delta Air Lines Inc.,SAN,"San Diego, CA: San Diego International",360,59,301
2005,9,2005-09,EV,Atlantic Southeast Airlines,SAN,"San Diego, CA: San Diego International",30,9,21
2005,9,2005-09,F9,Frontier Airlines Inc.,SAN,"San Diego, CA: San Diego International",149,11,138
2005,9,2005-09,HA,Hawaiian Airlines Inc.,SAN,"San Diego, CA: San Diego International",35,3,32
2005,9,2005-09,HP,America West Airlines Inc.,SAN,"San Diego, CA: San Diego International",355,38,317
2005,9,2005-09,MQ,American Eagle Airlines Inc.,SAN,"San Diego, CA: San Diego International",896,98,798
2005,9,2005-09,NW,Northwest Airlines Inc.,SAN,"San Diego, CA: San Diego International",150,87,63
2005,9,2005-09,OO,SkyWest Airlines Inc.,SAN,"San Diego, CA: San Diego International",762,93,669
2005,9,2005-09,UA,United Air Lines Inc.,SAN,"San Diego, CA: San Diego International",674,142,532
2005,9,2005-09,US,US Airways Inc.,SAN,"San Diego, CA: San Diego International",120,21,99
2005,9,2005-09,WN,Southwest Airlines Co.,SAN,"San Diego, CA: San Diego International",2566,434,2132
2005,10,2005-10,AA,American Airlines Inc.,SAN,"San Diego, CA: San Diego International",639,131,508
2005,10,2005-10,AS,Alaska Airlines Inc.,SAN,"San Diego, CA: San Diego International",369,73,296
2005,10,2005-10,B6,JetBlue Airways,SAN,"San Diego, CA: San Diego International",93,17,76
2005,10,2005-10,CO,Continental Air Lines Inc.,SAN,"San Diego, CA: San Diego International",273,41,232
2005,10,2005-10,DH,Independence Air,SAN,"San Diego, CA: San Diego International",28,6,22
2005,10,2005-10,DL,Delta Air Lines Inc.,SAN,"San Diego, CA: San Diego International",339,61,278
2005,10,2005-10,EV,Atlantic Southeast Airlines,SAN,"San Diego, CA: San Diego International",31,7,24
2005,10,2005-10,F9,Frontier Airlines Inc.,SAN,"San Diego, CA: San Diego International",154,14,140
2005,10,2005-10,HA,Hawaiian Airlines Inc.,SAN,"San Diego, CA: San Diego International",31,3,28
2005,10,2005-10,HP,America West Airlines Inc.,SAN,"San Diego, CA: San Diego International",367,53,314
2005,10,2005-10,MQ,American Eagle Airlines Inc.,SAN,"San Diego, CA: San Diego International",897,127,770
2005,10,2005-10,NW,Northwest Airlines Inc.,SAN,"San Diego, CA: San Diego International",181,32,149
2005,10,2005-10,OO,SkyWest Airlines Inc.,SAN,"San Diego, CA: San Diego International",784,113,671
2005,10,2005-10,UA,United Air Lines Inc.,SAN,"San Diego, CA: San Diego International",694,92,602
2005,10,2005-10,US,US Airways Inc.,SAN,"San Diego, CA: San Diego International",124,19,105
2005,10,2005-10,WN,Southwest Airlines Co.,SAN,"San Diego, CA: San Diego International",2637,532,2105
2005,11,2005-11,AA,American Airlines Inc.,SAN,"San Diego, CA: San Diego International",617,98,519
2005,11,2005-11,AS,Alaska Airlines Inc.,SAN,"San Diego, CA: San Diego International",329,73,256
2005,11,2005-11,B6,JetBlue Airways,SAN,"San Diego, CA: San Diego International",89,14,75
2005,11,2005-11,CO,Continental Air Lines Inc.,SAN,"San Diego, CA: San Diego International",257,18,239
2005,11,2005-11,DL,Delta Air Lines Inc.,SAN,"San Diego, CA: San Diego International",327,65,262
2005,11,2005-11,EV,Atlantic Southeast Airlines,SAN,"San Diego, CA: San Diego International",13,2,11
2005,11,2005-11,F9,Frontier Airlines Inc.,SAN,"San Diego, CA: San Diego International",146,11,135
2005,11,2005-11,HA,Hawaiian Airlines Inc.,SAN,"San Diego, CA: San Diego International",31,2,29
2005,11,2005-11,HP,America West Airlines Inc.,SAN,"San Diego, CA: San Diego International",356,31,325
2005,11,2005-11,MQ,American Eagle Airlines Inc.,SAN,"San Diego, CA: San Diego International",844,80,764
2005,11,2005-11,NW,Northwest Airlines Inc.,SAN,"San Diego, CA: San Diego International",175,51,124
2005,11,2005-11,OO,SkyWest Airlines Inc.,SAN,"San Diego, CA: San Diego International",751,114,637
2005,11,2005-11,UA,United Air Lines Inc.,SAN,"San Diego, CA: San Diego International",673,85,588
2005,11,2005-11,US,US Airways Inc.,SAN,"San Diego, CA: San Diego International",116,17,99
2005,11,2005-11,WN,Southwest Airlines Co.,SAN,"San Diego, CA: San Diego International",2515,315,2200
2005,12,2005-12,AA,American Airlines Inc.,SAN,"San Diego, CA: San Diego International",624,208,416
2005,12,2005-12,AS,Alaska Airlines Inc.,SAN,"San Diego, CA: San Diego International",348,119,229
2005,12,2005-12,B6,JetBlue Airways,SAN,"San Diego, CA: San Diego International",92,23,69
2005,12,2005-12,CO,Continental Air Lines Inc.,SAN,"San Diego, CA: San Diego International",309,73,236
2005,12,2005-12,DL,Delta Air Lines Inc.,SAN,"San Diego, CA: San Diego International",369,93,276
2005,12,2005-12,EV,Atlantic Southeast Airlines,SAN,"San Diego, CA: San Diego International",6,3,3
2005,12,2005-12,F9,Frontier Airlines Inc.,SAN,"San Diego, CA: San Diego International",152,67,85
2005,12,2005-12,HA,Hawaiian Airlines Inc.,SAN,"San Diego, CA: San Diego International",31,7,24
2005,12,2005-12,HP,America West Airlines Inc.,SAN,"San Diego, CA: San Diego International",367,78,289
2005,12,2005-12,MQ,American Eagle Airlines Inc.,SAN,"San Diego, CA: San Diego International",876,132,744
2005,12,2005-12,NW,Northwest Airlines Inc.,SAN,"San Diego, CA: San Diego International",179,71,108
2005,12,2005-12,OO,SkyWest Airlines Inc.,SAN,"San Diego, CA: San Diego International",795,153,642
2005,12,2005-12,UA,United Air Lines Inc.,SAN,"San Diego, CA: San Diego International",700,192,508
2005,12,2005-12,US,US Airways Inc.,SAN,"San Diego, CA: San Diego International",120,36,84
2005,12,2005-12,WN,Southwest Airlines Co.,SAN,"San Diego, CA: San Diego International",2622,555,2067
2006,1,2006-01,AA,American Airlines Inc.,SAN,"San Diego, CA: San Diego International",611,125,486
2006,1,2006-01,AS,Alaska Airlines Inc.,SAN,"San Diego, CA: San Diego International",343,115,228
2006,1,2006-01,B6,JetBlue Airways,SAN,"San Diego, CA: San Diego International",93,27,66
2006,1,2006-01,CO,Continental Air Lines Inc.,SAN,"San Diego, CA: San Diego International",267,48,219
2006,1,2006-01,DL,Delta Air Lines Inc.,SAN,"San Diego, CA: San Diego International",371,62,309
2006,1,2006-01,EV,Atlantic Southeast Airlines,SAN,"San Diego, CA: San Diego International",5,0,5
2006,1,2006-01,F9,Frontier Airlines Inc.,SAN,"San Diego, CA: San Diego International",154,33,121
2006,1,2006-01,HA,Hawaiian Airlines Inc.,SAN,"San Diego, CA: San Diego International",31,5,26
2006,1,2006-01,MQ,American Eagle Airlines Inc.,SAN,"San Diego, CA: San Diego International",879,90,789
2006,1,2006-01,NW,Northwest Airlines Inc.,SAN,"San Diego, CA: San Diego International",121,30,91
2006,1,2006-01,OO,SkyWest Airlines Inc.,SAN,"San Diego, CA: San Diego International",772,106,666
2006,1,2006-01,UA,United Air Lines Inc.,SAN,"San Diego, CA: San Diego International",701,154,547
2006,1,2006-01,US,US Airways Inc.,SAN,"San Diego, CA: San Diego International",444,65,379
2006,1,2006-01,WN,Southwest Airlines Co.,SAN,"San Diego, CA: San Diego International",2640,371,2269
2006,1,2006-01,YV,Mesa Airlines Inc.,SAN,"San Diego, CA: San Diego International",166,20,146
2006,2,2006-02,AA,American Airlines Inc.,SAN,"San Diego, CA: San Diego International",551,168,383
2006,2,2006-02,AS,Alaska Airlines Inc.,SAN,"San Diego, CA: San Diego International",321,89,232
2006,2,2006-02,B6,JetBlue Airways,SAN,"San Diego, CA: San Diego International",84,20,64
2006,2,2006-02,CO,Continental Air Lines Inc.,SAN,"San Diego, CA: San Diego International",250,76,174
2006,2,2006-02,DL,Delta Air Lines Inc.,SAN,"San Diego, CA: San Diego International",334,98,236
2006,2,2006-02,EV,Atlantic Southeast Airlines,SAN,"San Diego, CA: San Diego International",4,1,3
2006,2,2006-02,F9,Frontier Airlines Inc.,SAN,"San Diego, CA: San Diego International",140,53,87
2006,2,2006-02,HA,Hawaiian Airlines Inc.,SAN,"San Diego, CA: San Diego International",28,3,25
2006,2,2006-02,MQ,American Eagle Airlines Inc.,SAN,"San Diego, CA: San Diego International",797,67,730
2006,2,2006-02,NW,Northwest Airlines Inc.,SAN,"San Diego, CA: San Diego International",130,60,70
2006,2,2006-02,OO,SkyWest Airlines Inc.,SAN,"San Diego, CA: San Diego International",670,148,522
2006,2,2006-02,UA,United Air Lines Inc.,SAN,"San Diego, CA: San Diego International",658,199,459
2006,2,2006-02,US,US Airways Inc.,SAN,"San Diego, CA: San Diego International",389,66,323
2006,2,2006-02,WN,Southwest Airlines Co.,SAN,"San Diego, CA: San Diego International",2480,673,1807
2006,2,2006-02,YV,Mesa Airlines Inc.,SAN,"San Diego, CA: San Diego International",126,19,107
2006,3,2006-03,AA,American Airlines Inc.,SAN,"San Diego, CA: San Diego International",612,184,428
2006,3,2006-03,AS,Alaska Airlines Inc.,SAN,"San Diego, CA: San Diego International",372,110,262
2006,3,2006-03,B6,JetBlue Airways,SAN,"San Diego, CA: San Diego International",92,30,62
2006,3,2006-03,CO,Continental Air Lines Inc.,SAN,"San Diego, CA: San Diego International",301,107,194
2006,3,2006-03,DL,Delta Air Lines Inc.,SAN,"San Diego, CA: San Diego International",388,78,310
2006,3,2006-03,EV,Atlantic Southeast Airlines,SAN,"San Diego, CA: San Diego International",1,0,1
2006,3,2006-03,F9,Frontier Airlines Inc.,SAN,"San Diego, CA: San Diego International",143,73,70
2006,3,2006-03,HA,Hawaiian Airlines Inc.,SAN,"San Diego, CA: San Diego International",31,7,24
2006,3,2006-03,MQ,American Eagle Airlines Inc.,SAN,"San Diego, CA: San Diego International",886,58,828
2006,3,2006-03,NW,Northwest Airlines Inc.,SAN,"San Diego, CA: San Diego International",178,82,96
2006,3,2006-03,OO,SkyWest Airlines Inc.,SAN,"San Diego, CA: San Diego International",753,164,589
2006,3,2006-03,UA,United Air Lines Inc.,SAN,"San Diego, CA: San Diego International",740,269,471
2006,3,2006-03,US,US Airways Inc.,SAN,"San Diego, CA: San Diego International",458,76,382
2006,3,2006-03,WN,Southwest Airlines Co.,SAN,"San Diego, CA: San Diego International",2776,628,2148
2006,3,2006-03,YV,Mesa Airlines Inc.,SAN,"San Diego, CA: San Diego International",151,31,120
2006,4,2006-04,AA,American Airlines Inc.,SAN,"San Diego, CA: San Diego International",565,168,397
2006,4,2006-04,AQ,Aloha Airlines Inc.,SAN,"San Diego, CA: San Diego International",30,11,19
2006,4,2006-04,AS,Alaska Airlines Inc.,SAN,"San Diego, CA: San Diego International",358,102,256
2006,4,2006-04,B6,JetBlue Airways,SAN,"San Diego, CA: San Diego International",90,12,78
2006,4,2006-04,CO,Continental Air Lines Inc.,SAN,"San Diego, CA: San Diego International",271,97,174
2006,4,2006-04,DL,Delta Air Lines Inc.,SAN,"San Diego, CA: San Diego International",374,52,322
2006,4,2006-04,F9,Frontier Airlines Inc.,SAN,"San Diego, CA: San Diego International",139,34,105
2006,4,2006-04,HA,Hawaiian Airlines Inc.,SAN,"San Diego, CA: San Diego International",30,1,29
2006,4,2006-04,MQ,American Eagle Airlines Inc.,SAN,"San Diego, CA: San Diego International",877,70,807
2006,4,2006-04,NW,Northwest Airlines Inc.,SAN,"San Diego, CA: San Diego International",170,51,119
2006,4,2006-04,OO,SkyWest Airlines Inc.,SAN,"San Diego, CA: San Diego International",595,120,475
2006,4,2006-04,UA,United Air Lines Inc.,SAN,"San Diego, CA: San Diego International",706,209,497
2006,4,2006-04,US,US Airways Inc.,SAN,"San Diego, CA: San Diego International",499,101,398
2006,4,2006-04,WN,Southwest Airlines Co.,SAN,"San Diego, CA: San Diego International",2668,621,2047
2006,4,2006-04,YV,Mesa Airlines Inc.,SAN,"San Diego, CA: San Diego International",96,18,78
2006,5,2006-05,AA,American Airlines Inc.,SAN,"San Diego, CA: San Diego International",585,131,454
2006,5,2006-05,AQ,Aloha Airlines Inc.,SAN,"San Diego, CA: San Diego International",31,4,27
2006,5,2006-05,AS,Alaska Airlines Inc.,SAN,"San Diego, CA: San Diego International",341,81,260
2006,5,2006-05,B6,JetBlue Airways,SAN,"San Diego, CA: San Diego International",122,17,105
2006,5,2006-05,CO,Continental Air Lines Inc.,SAN,"San Diego, CA: San Diego International",291,62,229
2006,5,2006-05,DL,Delta Air Lines Inc.,SAN,"San Diego, CA: San Diego International",344,55,289
2006,5,2006-05,EV,Atlantic Southeast Airlines,SAN,"San Diego, CA: San Diego International",31,5,26
2006,5,2006-05,F9,Frontier Airlines Inc.,SAN,"San Diego, CA: San Diego International",161,43,118
2006,5,2006-05,HA,Hawaiian Airlines Inc.,SAN,"San Diego, CA: San Diego International",31,2,29
2006,5,2006-05,MQ,American Eagle Airlines Inc.,SAN,"San Diego, CA: San Diego International",905,47,858
2006,5,2006-05,NW,Northwest Airlines Inc.,SAN,"San Diego, CA: San Diego International",186,31,155
2006,5,2006-05,OO,SkyWest Airlines Inc.,SAN,"San Diego, CA: San Diego International",685,121,564
2006,5,2006-05,UA,United Air Lines Inc.,SAN,"San Diego, CA: San Diego International",762,168,594
2006,5,2006-05,US,US Airways Inc.,SAN,"San Diego, CA: San Diego International",566,83,483
2006,5,2006-05,WN,Southwest Airlines Co.,SAN,"San Diego, CA: San Diego International",2758,478,2280
2006,5,2006-05,YV,Mesa Airlines Inc.,SAN,"San Diego, CA: San Diego International",97,15,82
2006,6,2006-06,AA,American Airlines Inc.,SAN,"San Diego, CA: San Diego International",565,137,428
2006,6,2006-06,AQ,Aloha Airlines Inc.,SAN,"San Diego, CA: San Diego International",30,10,20
2006,6,2006-06,AS,Alaska Airlines Inc.,SAN,"San Diego, CA: San Diego International",330,77,253
2006,6,2006-06,B6,JetBlue Airways,SAN,"San Diego, CA: San Diego International",118,23,95
2006,6,2006-06,CO,Continental Air Lines Inc.,SAN,"San Diego, CA: San Diego International",340,108,232
2006,6,2006-06,DL,Delta Air Lines Inc.,SAN,"San Diego, CA: San Diego International",367,101,266
2006,6,2006-06,EV,Atlantic Southeast Airlines,SAN,"San Diego, CA: San Diego International",30,5,25
2006,6,2006-06,F9,Frontier Airlines Inc.,SAN,"San Diego, CA: San Diego International",179,47,132
2006,6,2006-06,HA,Hawaiian Airlines Inc.,SAN,"San Diego, CA: San Diego International",52,12,40
2006,6,2006-06,MQ,American Eagle Airlines Inc.,SAN,"San Diego, CA: San Diego International",883,78,805
2006,6,2006-06,NW,Northwest Airlines Inc.,SAN,"San Diego, CA: San Diego International",180,42,138
2006,6,2006-06,OO,SkyWest Airlines Inc.,SAN,"San Diego, CA: San Diego International",706,124,582
2006,6,2006-06,UA,United Air Lines Inc.,SAN,"San Diego, CA: San Diego International",745,181,564
2006,6,2006-06,US,US Airways Inc.,SAN,"San Diego, CA: San Diego International",566,139,427
2006,6,2006-06,WN,Southwest Airlines Co.,SAN,"San Diego, CA: San Diego International",2704,562,2142
2006,6,2006-06,YV,Mesa Airlines Inc.,SAN,"San Diego, CA: San Diego International",98,10,88
2006,7,2006-07,AA,American Airlines Inc.,SAN,"San Diego, CA: San Diego International",584,148,436
2006,7,2006-07,AQ,Aloha Airlines Inc.,SAN,"San Diego, CA: San Diego International",31,10,21
2006,7,2006-07,AS,Alaska Airlines Inc.,SAN,"San Diego, CA: San Diego International",371,136,235
2006,7,2006-07,B6,JetBlue Airways,SAN,"San Diego, CA: San Diego International",122,25,97
2006,7,2006-07,CO,Continental Air Lines Inc.,SAN,"San Diego, CA: San Diego International",365,93,272
2006,7,2006-07,DL,Delta Air Lines Inc.,SAN,"San Diego, CA: San Diego International",416,93,323
2006,7,2006-07,F9,Frontier Airlines Inc.,SAN,"San Diego, CA: San Diego International",181,42,139
2006,7,2006-07,HA,Hawaiian Airlines Inc.,SAN,"San Diego, CA: San Diego International",62,6,56
2006,7,2006-07,MQ,American Eagle Airlines Inc.,SAN,"San Diego, CA: San Diego International",903,76,827
2006,7,2006-07,NW,Northwest Airlines Inc.,SAN,"San Diego, CA: San Diego International",186,41,145
2006,7,2006-07,OO,SkyWest Airlines Inc.,SAN,"San Diego, CA: San Diego International",727,200,527
2006,7,2006-07,UA,United Air Lines Inc.,SAN,"San Diego, CA: San Diego International",762,172,590
2006,7,2006-07,US,US Airways Inc.,SAN,"San Diego, CA: San Diego International",584,168,416
2006,7,2006-07,WN,Southwest Airlines Co.,SAN,"San Diego, CA: San Diego International",2776,554,2222
2006,7,2006-07,YV,Mesa Airlines Inc.,SAN,"San Diego, CA: San Diego International",103,26,77
2006,8,2006-08,AA,American Airlines Inc.,SAN,"San Diego, CA: San Diego International",588,147,441
2006,8,2006-08,AQ,Aloha Airlines Inc.,SAN,"San Diego, CA: San Diego International",31,8,23
2006,8,2006-08,AS,Alaska Airlines Inc.,SAN,"San Diego, CA: San Diego International",372,104,268
2006,8,2006-08,B6,JetBlue Airways,SAN,"San Diego, CA: San Diego International",123,15,108
2006,8,2006-08,CO,Continental Air Lines Inc.,SAN,"San Diego, CA: San Diego International",358,81,277
2006,8,2006-08,DL,Delta Air Lines Inc.,SAN,"San Diego, CA: San Diego International",420,95,325
2006,8,2006-08,F9,Frontier Airlines Inc.,SAN,"San Diego, CA: San Diego International",183,39,144
2006,8,2006-08,HA,Hawaiian Airlines Inc.,SAN,"San Diego, CA: San Diego International",62,8,54
2006,8,2006-08,MQ,American Eagle Airlines Inc.,SAN,"San Diego, CA: San Diego International",914,69,845
2006,8,2006-08,NW,Northwest Airlines Inc.,SAN,"San Diego, CA: San Diego International",175,78,97
2006,8,2006-08,OO,SkyWest Airlines Inc.,SAN,"San Diego, CA: San Diego International",737,192,545
2006,8,2006-08,UA,United Air Lines Inc.,SAN,"San Diego, CA: San Diego International",770,167,603
2006,8,2006-08,US,US Airways Inc.,SAN,"San Diego, CA: San Diego International",585,166,419
2006,8,2006-08,WN,Southwest Airlines Co.,SAN,"San Diego, CA: San Diego International",2812,445,2367
2006,8,2006-08,YV,Mesa Airlines Inc.,SAN,"San Diego, CA: San Diego International",101,19,82
2006,9,2006-09,AA,American Airlines Inc.,SAN,"San Diego, CA: San Diego International",565,130,435
2006,9,2006-09,AQ,Aloha Airlines Inc.,SAN,"San Diego, CA: San Diego International",30,3,27
2006,9,2006-09,AS,Alaska Airlines Inc.,SAN,"San Diego, CA: San Diego International",360,60,300
2006,9,2006-09,B6,JetBlue Airways,SAN,"San Diego, CA: San Diego International",107,35,72
2006,9,2006-09,CO,Continental Air Lines Inc.,SAN,"San Diego, CA: San Diego International",274,60,214
2006,9,2006-09,DL,Delta Air Lines Inc.,SAN,"San Diego, CA: San Diego International",339,137,202
2006,9,2006-09,EV,Atlantic Southeast Airlines,SAN,"San Diego, CA: San Diego International",56,5,51
2006,9,2006-09,F9,Frontier Airlines Inc.,SAN,"San Diego, CA: San Diego International",179,27,152
2006,9,2006-09,HA,Hawaiian Airlines Inc.,SAN,"San Diego, CA: San Diego International",56,5,51
2006,9,2006-09,MQ,American Eagle Airlines Inc.,SAN,"San Diego, CA: San Diego International",794,94,700
2006,9,2006-09,NW,Northwest Airlines Inc.,SAN,"San Diego, CA: San Diego International",150,37,113
2006,9,2006-09,OO,SkyWest Airlines Inc.,SAN,"San Diego, CA: San Diego International",670,116,554
2006,9,2006-09,UA,United Air Lines Inc.,SAN,"San Diego, CA: San Diego International",725,154,571
2006,9,2006-09,US,US Airways Inc.,SAN,"San Diego, CA: San Diego International",538,150,388
2006,9,2006-09,WN,Southwest Airlines Co.,SAN,"San Diego, CA: San Diego International",2679,364,2315
2006,9,2006-09,YV,Mesa Airlines Inc.,SAN,"San Diego, CA: San Diego International",71,14,57
2006,10,2006-10,AA,American Airlines Inc.,SAN,"San Diego, CA: San Diego International",585,127,458
2006,10,2006-10,AQ,Aloha Airlines Inc.,SAN,"San Diego, CA: San Diego International",31,4,27
2006,10,2006-10,AS,Alaska Airlines Inc.,SAN,"San Diego, CA: San Diego International",374,59,315
2006,10,2006-10,B6,JetBlue Airways,SAN,"San Diego, CA: San Diego International",111,68,43
2006,10,2006-10,CO,Continental Air Lines Inc.,SAN,"San Diego, CA: San Diego International",278,93,185
2006,10,2006-10,DL,Delta Air Lines Inc.,SAN,"San Diego, CA: San Diego International",348,129,219
2006,10,2006-10,EV,Atlantic Southeast Airlines,SAN,"San Diego, CA: San Diego International",57,8,49
2006,10,2006-10,F9,Frontier Airlines Inc.,SAN,"San Diego, CA: San Diego International",186,32,154
2006,10,2006-10,HA,Hawaiian Airlines Inc.,SAN,"San Diego, CA: San Diego International",62,6,56
2006,10,2006-10,MQ,American Eagle Airlines Inc.,SAN,"San Diego, CA: San Diego International",818,81,737
2006,10,2006-10,NW,Northwest Airlines Inc.,SAN,"San Diego, CA: San Diego International",186,87,99
2006,10,2006-10,OO,SkyWest Airlines Inc.,SAN,"San Diego, CA: San Diego International",699,155,544
2006,10,2006-10,UA,United Air Lines Inc.,SAN,"San Diego, CA: San Diego International",764,177,587
2006,10,2006-10,US,US Airways Inc.,SAN,"San Diego, CA: San Diego International",553,150,403
2006,10,2006-10,WN,Southwest Airlines Co.,SAN,"San Diego, CA: San Diego International",2790,511,2279
2006,10,2006-10,YV,Mesa Airlines Inc.,SAN,"San Diego, CA: San Diego International",70,11,59
2006,11,2006-11,AA,American Airlines Inc.,SAN,"San Diego, CA: San Diego International",561,96,465
2006,11,2006-11,AQ,Aloha Airlines Inc.,SAN,"San Diego, CA: San Diego International",30,8,22
2006,11,2006-11,AS,Alaska Airlines Inc.,SAN,"San Diego, CA: San Diego International",405,128,277
2006,11,2006-11,B6,JetBlue Airways,SAN,"San Diego, CA: San Diego International",88,22,66
2006,11,2006-11,CO,Continental Air Lines Inc.,SAN,"San Diego, CA: San Diego International",269,55,214
2006,11,2006-11,DL,Delta Air Lines Inc.,SAN,"San Diego, CA: San Diego International",327,90,237
2006,11,2006-11,EV,Atlantic Southeast Airlines,SAN,"San Diego, CA: San Diego International",30,5,25
2006,11,2006-11,F9,Frontier Airlines Inc.,SAN,"San Diego, CA: San Diego International",176,21,155
2006,11,2006-11,HA,Hawaiian Airlines Inc.,SAN,"San Diego, CA: San Diego International",56,9,47
2006,11,2006-11,MQ,American Eagle Airlines Inc.,SAN,"San Diego, CA: San Diego International",812,91,721
2006,11,2006-11,NW,Northwest Airlines Inc.,SAN,"San Diego, CA: San Diego International",179,74,105
2006,11,2006-11,OO,SkyWest Airlines Inc.,SAN,"San Diego, CA: San Diego International",648,97,551
2006,11,2006-11,UA,United Air Lines Inc.,SAN,"San Diego, CA: San Diego International",698,122,576
2006,11,2006-11,US,US Airways Inc.,SAN,"San Diego, CA: San Diego International",527,107,420
2006,11,2006-11,WN,Southwest Airlines Co.,SAN,"San Diego, CA: San Diego International",2649,399,2250
2006,11,2006-11,YV,Mesa Airlines Inc.,SAN,"San Diego, CA: San Diego International",64,8,56
2006,12,2006-12,AA,American Airlines Inc.,SAN,"San Diego, CA: San Diego International",580,159,421
2006,12,2006-12,AQ,Aloha Airlines Inc.,SAN,"San Diego, CA: San Diego International",31,5,26
2006,12,2006-12,AS,Alaska Airlines Inc.,SAN,"San Diego, CA: San Diego International",419,117,302
2006,12,2006-12,B6,JetBlue Airways,SAN,"San Diego, CA: San Diego International",93,25,68
2006,12,2006-12,CO,Continental Air Lines Inc.,SAN,"San Diego, CA: San Diego International",332,76,256
2006,12,2006-12,DL,Delta Air Lines Inc.,SAN,"San Diego, CA: San Diego International",308,42,266
2006,12,2006-12,EV,Atlantic Southeast Airlines,SAN,"San Diego, CA: San Diego International",31,9,22
2006,12,2006-12,F9,Frontier Airlines Inc.,SAN,"San Diego, CA: San Diego International",180,34,146
2006,12,2006-12,HA,Hawaiian Airlines Inc.,SAN,"San Diego, CA: San Diego International",62,16,46
2006,12,2006-12,MQ,American Eagle Airlines Inc.,SAN,"San Diego, CA: San Diego International",873,139,734
2006,12,2006-12,NW,Northwest Airlines Inc.,SAN,"San Diego, CA: San Diego International",182,65,117
2006,12,2006-12,OO,SkyWest Airlines Inc.,SAN,"San Diego, CA: San Diego International",690,139,551
2006,12,2006-12,UA,United Air Lines Inc.,SAN,"San Diego, CA: San Diego International",717,166,551
2006,12,2006-12,US,US Airways Inc.,SAN,"San Diego, CA: San Diego International",541,148,393
2006,12,2006-12,WN,Southwest Airlines Co.,SAN,"San Diego, CA: San Diego International",2687,535,2152
2006,12,2006-12,YV,Mesa Airlines Inc.,SAN,"San Diego, CA: San Diego International",62,13,49
2007,1,2007-01,AA,American Airlines Inc.,SAN,"San Diego, CA: San Diego International",584,210,374
2007,1,2007-01,AQ,Aloha Airlines Inc.,SAN,"San Diego, CA: San Diego International",31,5,26
2007,1,2007-01,AS,Alaska Airlines Inc.,SAN,"San Diego, CA: San Diego International",422,91,331
2007,1,2007-01,B6,JetBlue Airways,SAN,"San Diego, CA: San Diego International",93,31,62
2007,1,2007-01,CO,Continental Air Lines Inc.,SAN,"San Diego, CA: San Diego International",285,74,211
2007,1,2007-01,DL,Delta Air Lines Inc.,SAN,"San Diego, CA: San Diego International",294,67,227
2007,1,2007-01,EV,Atlantic Southeast Airlines,SAN,"San Diego, CA: San Diego International",5,2,3
2007,1,2007-01,F9,Frontier Airlines Inc.,SAN,"San Diego, CA: San Diego International",181,53,128
2007,1,2007-01,HA,Hawaiian Airlines Inc.,SAN,"San Diego, CA: San Diego International",39,9,30
2007,1,2007-01,MQ,American Eagle Airlines Inc.,SAN,"San Diego, CA: San Diego International",848,94,754
2007,1,2007-01,NW,Northwest Airlines Inc.,SAN,"San Diego, CA: San Diego International",118,31,87
2007,1,2007-01,OO,SkyWest Airlines Inc.,SAN,"San Diego, CA: San Diego International",696,157,539
2007,1,2007-01,UA,United Air Lines Inc.,SAN,"San Diego, CA: San Diego International",726,171,555
2007,1,2007-01,US,US Airways Inc.,SAN,"San Diego, CA: San Diego International",532,169,363
2007,1,2007-01,WN,Southwest Airlines Co.,SAN,"San Diego, CA: San Diego International",2751,406,2345
2007,1,2007-01,YV,Mesa Airlines Inc.,SAN,"San Diego, CA: San Diego International",69,9,60
2007,2,2007-02,AA,American Airlines Inc.,SAN,"San Diego, CA: San Diego International",527,179,348
2007,2,2007-02,AQ,Aloha Airlines Inc.,SAN,"San Diego, CA: San Diego International",28,4,24
2007,2,2007-02,AS,Alaska Airlines Inc.,SAN,"San Diego, CA: San Diego International",383,94,289
2007,2,2007-02,B6,JetBlue Airways,SAN,"San Diego, CA: San Diego International",83,25,58
2007,2,2007-02,CO,Continental Air Lines Inc.,SAN,"San Diego, CA: San Diego International",250,56,194
2007,2,2007-02,DL,Delta Air Lines Inc.,SAN,"San Diego, CA: San Diego International",270,63,207
2007,2,2007-02,F9,Frontier Airlines Inc.,SAN,"San Diego, CA: San Diego International",164,44,120
2007,2,2007-02,HA,Hawaiian Airlines Inc.,SAN,"San Diego, CA: San Diego International",30,10,20
2007,2,2007-02,MQ,American Eagle Airlines Inc.,SAN,"San Diego, CA: San Diego International",734,86,648
2007,2,2007-02,NW,Northwest Airlines Inc.,SAN,"San Diego, CA: San Diego International",132,66,66
2007,2,2007-02,OO,SkyWest Airlines Inc.,SAN,"San Diego, CA: San Diego International",628,158,470
2007,2,2007-02,UA,United Air Lines Inc.,SAN,"San Diego, CA: San Diego International",672,231,441
2007,2,2007-02,US,US Airways Inc.,SAN,"San Diego, CA: San Diego International",473,190,283
2007,2,2007-02,WN,Southwest Airlines Co.,SAN,"San Diego, CA: San Diego International",2484,468,2016
2007,2,2007-02,YV,Mesa Airlines Inc.,SAN,"San Diego, CA: San Diego International",62,9,53
2007,3,2007-03,AA,American Airlines Inc.,SAN,"San Diego, CA: San Diego International",584,147,437
2007,3,2007-03,AQ,Aloha Airlines Inc.,SAN,"San Diego, CA: San Diego International",31,4,27
2007,3,2007-03,AS,Alaska Airlines Inc.,SAN,"San Diego, CA: San Diego International",421,90,331
2007,3,2007-03,B6,JetBlue Airways,SAN,"San Diego, CA: San Diego International",93,16,77
2007,3,2007-03,CO,Continental Air Lines Inc.,SAN,"San Diego, CA: San Diego International",299,57,242
2007,3,2007-03,DL,Delta Air Lines Inc.,SAN,"San Diego, CA: San Diego International",301,41,260
2007,3,2007-03,F9,Frontier Airlines Inc.,SAN,"San Diego, CA: San Diego International",181,19,162
2007,3,2007-03,HA,Hawaiian Airlines Inc.,SAN,"San Diego, CA: San Diego International",47,17,30
2007,3,2007-03,MQ,American Eagle Airlines Inc.,SAN,"San Diego, CA: San Diego International",811,61,750
2007,3,2007-03,NW,Northwest Airlines Inc.,SAN,"San Diego, CA: San Diego International",177,56,121
2007,3,2007-03,OO,SkyWest Airlines Inc.,SAN,"San Diego, CA: San Diego International",698,150,548
2007,3,2007-03,UA,United Air Lines Inc.,SAN,"San Diego, CA: San Diego International",760,157,603
2007,3,2007-03,US,US Airways Inc.,SAN,"San Diego, CA: San Diego International",521,188,333
2007,3,2007-03,WN,Southwest Airlines Co.,SAN,"San Diego, CA: San Diego International",2833,350,2483
2007,3,2007-03,YV,Mesa Airlines Inc.,SAN,"San Diego, CA: San Diego International",67,12,55
2007,4,2007-04,AA,American Airlines Inc.,SAN,"San Diego, CA: San Diego International",569,161,408
2007,4,2007-04,AQ,Aloha Airlines Inc.,SAN,"San Diego, CA: San Diego International",30,3,27
2007,4,2007-04,AS,Alaska Airlines Inc.,SAN,"San Diego, CA: San Diego International",407,77,330
2007,4,2007-04,B6,JetBlue Airways,SAN,"San Diego, CA: San Diego International",90,28,62
2007,4,2007-04,CO,Continental Air Lines Inc.,SAN,"San Diego, CA: San Diego International",287,76,211
2007,4,2007-04,DL,Delta Air Lines Inc.,SAN,"San Diego, CA: San Diego International",292,49,243
2007,4,2007-04,F9,Frontier Airlines Inc.,SAN,"San Diego, CA: San Diego International",175,23,152
2007,4,2007-04,HA,Hawaiian Airlines Inc.,SAN,"San Diego, CA: San Diego International",60,17,43
2007,4,2007-04,MQ,American Eagle Airlines Inc.,SAN,"San Diego, CA: San Diego International",666,52,614
2007,4,2007-04,NW,Northwest Airlines Inc.,SAN,"San Diego, CA: San Diego International",171,44,127
2007,4,2007-04,OO,SkyWest Airlines Inc.,SAN,"San Diego, CA: San Diego International",671,105,566
2007,4,2007-04,UA,United Air Lines Inc.,SAN,"San Diego, CA: San Diego International",734,191,543
2007,4,2007-04,US,US Airways Inc.,SAN,"San Diego, CA: San Diego International",457,145,312
2007,4,2007-04,WN,Southwest Airlines Co.,SAN,"San Diego, CA: San Diego International",2790,402,2388
2007,4,2007-04,YV,Mesa Airlines Inc.,SAN,"San Diego, CA: San Diego International",41,6,35
2007,5,2007-05,AA,American Airlines Inc.,SAN,"San Diego, CA: San Diego International",586,148,438
2007,5,2007-05,AQ,Aloha Airlines Inc.,SAN,"San Diego, CA: San Diego International",31,4,27
2007,5,2007-05,AS,Alaska Airlines Inc.,SAN,"San Diego, CA: San Diego International",430,90,340
2007,5,2007-05,B6,JetBlue Airways,SAN,"San Diego, CA: San Diego International",112,17,95
2007,5,2007-05,CO,Continental Air Lines Inc.,SAN,"San Diego, CA: San Diego International",294,52,242
2007,5,2007-05,DL,Delta Air Lines Inc.,SAN,"San Diego, CA: San Diego International",287,33,254
2007,5,2007-05,F9,Frontier Airlines Inc.,SAN,"San Diego, CA: San Diego International",182,31,151
2007,5,2007-05,FL,AirTran Airways Corporation,SAN,"San Diego, CA: San Diego International",9,5,4
2007,5,2007-05,HA,Hawaiian Airlines Inc.,SAN,"San Diego, CA: San Diego International",62,20,42
2007,5,2007-05,MQ,American Eagle Airlines Inc.,SAN,"San Diego, CA: San Diego International",689,70,619
2007,5,2007-05,NW,Northwest Airlines Inc.,SAN,"San Diego, CA: San Diego International",186,33,153
2007,5,2007-05,OO,SkyWest Airlines Inc.,SAN,"San Diego, CA: San Diego International",679,64,615
2007,5,2007-05,UA,United Air Lines Inc.,SAN,"San Diego, CA: San Diego International",754,191,563
2007,5,2007-05,US,US Airways Inc.,SAN,"San Diego, CA: San Diego International",465,105,360
2007,5,2007-05,WN,Southwest Airlines Co.,SAN,"San Diego, CA: San Diego International",2863,375,2488
2007,5,2007-05,XE,ExpressJet Airlines Inc.,SAN,"San Diego, CA: San Diego International",263,30,233
2007,5,2007-05,YV,Mesa Airlines Inc.,SAN,"San Diego, CA: San Diego International",33,5,28
2007,6,2007-06,AA,American Airlines Inc.,SAN,"San Diego, CA: San Diego International",570,204,366
2007,6,2007-06,AQ,Aloha Airlines Inc.,SAN,"San Diego, CA: San Diego International",30,2,28
2007,6,2007-06,AS,Alaska Airlines Inc.,SAN,"San Diego, CA: San Diego International",471,110,361
2007,6,2007-06,B6,JetBlue Airways,SAN,"San Diego, CA: San Diego International",113,31,82
2007,6,2007-06,CO,Continental Air Lines Inc.,SAN,"San Diego, CA: San Diego International",367,99,268
2007,6,2007-06,DL,Delta Air Lines Inc.,SAN,"San Diego, CA: San Diego International",352,128,224
2007,6,2007-06,F9,Frontier Airlines Inc.,SAN,"San Diego, CA: San Diego International",175,42,133
2007,6,2007-06,FL,AirTran Airways Corporation,SAN,"San Diego, CA: San Diego International",61,35,26
2007,6,2007-06,HA,Hawaiian Airlines Inc.,SAN,"San Diego, CA: San Diego International",60,11,49
2007,6,2007-06,MQ,American Eagle Airlines Inc.,SAN,"San Diego, CA: San Diego International",717,90,627
2007,6,2007-06,NW,Northwest Airlines Inc.,SAN,"San Diego, CA: San Diego International",180,53,127
2007,6,2007-06,OO,SkyWest Airlines Inc.,SAN,"San Diego, CA: San Diego International",634,59,575
2007,6,2007-06,UA,United Air Lines Inc.,SAN,"San Diego, CA: San Diego International",732,262,470
2007,6,2007-06,US,US Airways Inc.,SAN,"San Diego, CA: San Diego International",505,160,345
2007,6,2007-06,WN,Southwest Airlines Co.,SAN,"San Diego, CA: San Diego International",2801,567,2234
2007,6,2007-06,XE,ExpressJet Airlines Inc.,SAN,"San Diego, CA: San Diego International",532,48,484
2007,6,2007-06,YV,Mesa Airlines Inc.,SAN,"San Diego, CA: San Diego International",39,4,35
2007,7,2007-07,AA,American Airlines Inc.,SAN,"San Diego, CA: San Diego International",588,193,395
2007,7,2007-07,AQ,Aloha Airlines Inc.,SAN,"San Diego, CA: San Diego International",31,4,27
2007,7,2007-07,AS,Alaska Airlines Inc.,SAN,"San Diego, CA: San Diego International",492,158,334
2007,7,2007-07,B6,JetBlue Airways,SAN,"San Diego, CA: San Diego International",149,30,119
2007,7,2007-07,CO,Continental Air Lines Inc.,SAN,"San Diego, CA: San Diego International",392,80,312
2007,7,2007-07,DL,Delta Air Lines Inc.,SAN,"San Diego, CA: San Diego International",398,116,282
2007,7,2007-07,F9,Frontier Airlines Inc.,SAN,"San Diego, CA: San Diego International",180,51,129
2007,7,2007-07,FL,AirTran Airways Corporation,SAN,"San Diego, CA: San Diego International",95,33,62
2007,7,2007-07,HA,Hawaiian Airlines Inc.,SAN,"San Diego, CA: San Diego International",62,10,52
2007,7,2007-07,MQ,American Eagle Airlines Inc.,SAN,"San Diego, CA: San Diego International",759,110,649
2007,7,2007-07,NW,Northwest Airlines Inc.,SAN,"San Diego, CA: San Diego International",184,35,149
2007,7,2007-07,OO,SkyWest Airlines Inc.,SAN,"San Diego, CA: San Diego International",629,88,541
2007,7,2007-07,UA,United Air Lines Inc.,SAN,"San Diego, CA: San Diego International",749,213,536
2007,7,2007-07,US,US Airways Inc.,SAN,"San Diego, CA: San Diego International",517,128,389
2007,7,2007-07,WN,Southwest Airlines Co.,SAN,"San Diego, CA: San Diego International",2896,588,2308
2007,7,2007-07,XE,ExpressJet Airlines Inc.,SAN,"San Diego, CA: San Diego International",558,89,469
2007,7,2007-07,YV,Mesa Airlines Inc.,SAN,"San Diego, CA: San Diego International",39,5,34
2007,8,2007-08,AA,American Airlines Inc.,SAN,"San Diego, CA: San Diego International",588,162,426
2007,8,2007-08,AQ,Aloha Airlines Inc.,SAN,"San Diego, CA: San Diego International",31,3,28
2007,8,2007-08,AS,Alaska Airlines Inc.,SAN,"San Diego, CA: San Diego International",492,154,338
2007,8,2007-08,B6,JetBlue Airways,SAN,"San Diego, CA: San Diego International",185,35,150
2007,8,2007-08,CO,Continental Air Lines Inc.,SAN,"San Diego, CA: San Diego International",399,76,323
2007,8,2007-08,DL,Delta Air Lines Inc.,SAN,"San Diego, CA: San Diego International",422,116,306
2007,8,2007-08,F9,Frontier Airlines Inc.,SAN,"San Diego, CA: San Diego International",182,45,137
2007,8,2007-08,FL,AirTran Airways Corporation,SAN,"San Diego, CA: San Diego International",102,31,71
2007,8,2007-08,HA,Hawaiian Airlines Inc.,SAN,"San Diego, CA: San Diego International",62,7,55
2007,8,2007-08,MQ,American Eagle Airlines Inc.,SAN,"San Diego, CA: San Diego International",758,132,626
2007,8,2007-08,NW,Northwest Airlines Inc.,SAN,"San Diego, CA: San Diego International",173,68,105
2007,8,2007-08,OO,SkyWest Airlines Inc.,SAN,"San Diego, CA: San Diego International",613,78,535
2007,8,2007-08,UA,United Air Lines Inc.,SAN,"San Diego, CA: San Diego International",732,251,481
2007,8,2007-08,US,US Airways Inc.,SAN,"San Diego, CA: San Diego International",512,132,380
2007,8,2007-08,WN,Southwest Airlines Co.,SAN,"San Diego, CA: San Diego International",2962,578,2384
2007,8,2007-08,XE,ExpressJet Airlines Inc.,SAN,"San Diego, CA: San Diego International",603,56,547
2007,8,2007-08,YV,Mesa Airlines Inc.,SAN,"San Diego, CA: San Diego International",38,6,32
2007,9,2007-09,AA,American Airlines Inc.,SAN,"San Diego, CA: San Diego International",537,97,440
2007,9,2007-09,AQ,Aloha Airlines Inc.,SAN,"San Diego, CA: San Diego International",30,3,27
2007,9,2007-09,AS,Alaska Airlines Inc.,SAN,"San Diego, CA: San Diego International",388,128,260
2007,9,2007-09,B6,JetBlue Airways,SAN,"San Diego, CA: San Diego International",173,11,162
2007,9,2007-09,CO,Continental Air Lines Inc.,SAN,"San Diego, CA: San Diego International",302,27,275
2007,9,2007-09,DL,Delta Air Lines Inc.,SAN,"San Diego, CA: San Diego International",395,106,289
2007,9,2007-09,F9,Frontier Airlines Inc.,SAN,"San Diego, CA: San Diego International",178,24,154
2007,9,2007-09,FL,AirTran Airways Corporation,SAN,"San Diego, CA: San Diego International",72,13,59
2007,9,2007-09,HA,Hawaiian Airlines Inc.,SAN,"San Diego, CA: San Diego International",60,5,55
2007,9,2007-09,MQ,American Eagle Airlines Inc.,SAN,"San Diego, CA: San Diego International",752,97,655
2007,9,2007-09,NW,Northwest Airlines Inc.,SAN,"San Diego, CA: San Diego International",150,51,99
2007,9,2007-09,OO,SkyWest Airlines Inc.,SAN,"San Diego, CA: San Diego International",542,69,473
2007,9,2007-09,UA,United Air Lines Inc.,SAN,"San Diego, CA: San Diego International",704,157,547
2007,9,2007-09,US,US Airways Inc.,SAN,"San Diego, CA: San Diego International",480,77,403
2007,9,2007-09,WN,Southwest Airlines Co.,SAN,"San Diego, CA: San Diego International",3021,373,2648
2007,9,2007-09,XE,ExpressJet Airlines Inc.,SAN,"San Diego, CA: San Diego International",574,56,518
2007,9,2007-09,YV,Mesa Airlines Inc.,SAN,"San Diego, CA: San Diego International",31,6,25
2007,10,2007-10,AA,American Airlines Inc.,SAN,"San Diego, CA: San Diego International",554,124,430
2007,10,2007-10,AQ,Aloha Airlines Inc.,SAN,"San Diego, CA: San Diego International",31,3,28
2007,10,2007-10,AS,Alaska Airlines Inc.,SAN,"San Diego, CA: San Diego International",364,112,252
2007,10,2007-10,B6,JetBlue Airways,SAN,"San Diego, CA: San Diego International",176,28,148
2007,10,2007-10,CO,Continental Air Lines Inc.,SAN,"San Diego, CA: San Diego International",283,33,250
2007,10,2007-10,DL,Delta Air Lines Inc.,SAN,"San Diego, CA: San Diego International",405,46,359
2007,10,2007-10,F9,Frontier Airlines Inc.,SAN,"San Diego, CA: San Diego International",184,32,152
2007,10,2007-10,FL,AirTran Airways Corporation,SAN,"San Diego, CA: San Diego International",70,24,46
2007,10,2007-10,HA,Hawaiian Airlines Inc.,SAN,"San Diego, CA: San Diego International",62,8,54
2007,10,2007-10,MQ,American Eagle Airlines Inc.,SAN,"San Diego, CA: San Diego International",793,106,687
2007,10,2007-10,NW,Northwest Airlines Inc.,SAN,"San Diego, CA: San Diego International",186,67,119
2007,10,2007-10,OO,SkyWest Airlines Inc.,SAN,"San Diego, CA: San Diego International",573,97,476
2007,10,2007-10,UA,United Air Lines Inc.,SAN,"San Diego, CA: San Diego International",754,183,571
2007,10,2007-10,US,US Airways Inc.,SAN,"San Diego, CA: San Diego International",497,93,404
2007,10,2007-10,WN,Southwest Airlines Co.,SAN,"San Diego, CA: San Diego International",3144,582,2562
2007,10,2007-10,XE,ExpressJet Airlines Inc.,SAN,"San Diego, CA: San Diego International",576,67,509
2007,10,2007-10,YV,Mesa Airlines Inc.,SAN,"San Diego, CA: San Diego International",8,2,6
2007,11,2007-11,AA,American Airlines Inc.,SAN,"San Diego, CA: San Diego International",530,133,397
2007,11,2007-11,AQ,Aloha Airlines Inc.,SAN,"San Diego, CA: San Diego International",30,8,22
2007,11,2007-11,AS,Alaska Airlines Inc.,SAN,"San Diego, CA: San Diego International",316,68,248
2007,11,2007-11,B6,JetBlue Airways,SAN,"San Diego, CA: San Diego International",149,19,130
2007,11,2007-11,CO,Continental Air Lines Inc.,SAN,"San Diego, CA: San Diego International",271,63,208
2007,11,2007-11,DL,Delta Air Lines Inc.,SAN,"San Diego, CA: San Diego International",384,67,317
2007,11,2007-11,F9,Frontier Airlines Inc.,SAN,"San Diego, CA: San Diego International",166,28,138
2007,11,2007-11,FL,AirTran Airways Corporation,SAN,"San Diego, CA: San Diego International",66,20,46
2007,11,2007-11,HA,Hawaiian Airlines Inc.,SAN,"San Diego, CA: San Diego International",60,20,40
2007,11,2007-11,MQ,American Eagle Airlines Inc.,SAN,"San Diego, CA: San Diego International",767,123,644
2007,11,2007-11,NW,Northwest Airlines Inc.,SAN,"San Diego, CA: San Diego International",177,52,125
2007,11,2007-11,OO,SkyWest Airlines Inc.,SAN,"San Diego, CA: San Diego International",539,124,415
2007,11,2007-11,UA,United Air Lines Inc.,SAN,"San Diego, CA: San Diego International",713,186,527
2007,11,2007-11,US,US Airways Inc.,SAN,"San Diego, CA: San Diego International",464,81,383
2007,11,2007-11,WN,Southwest Airlines Co.,SAN,"San Diego, CA: San Diego International",2969,494,2475
2007,11,2007-11,XE,ExpressJet Airlines Inc.,SAN,"San Diego, CA: San Diego International",570,90,480
2007,11,2007-11,YV,Mesa Airlines Inc.,SAN,"San Diego, CA: San Diego International",31,6,25
2007,12,2007-12,AA,American Airlines Inc.,SAN,"San Diego, CA: San Diego International",526,226,300
2007,12,2007-12,AQ,Aloha Airlines Inc.,SAN,"San Diego, CA: San Diego International",31,4,27
2007,12,2007-12,AS,Alaska Airlines Inc.,SAN,"San Diego, CA: San Diego International",341,78,263
2007,12,2007-12,B6,JetBlue Airways,SAN,"San Diego, CA: San Diego International",155,55,100
2007,12,2007-12,CO,Continental Air Lines Inc.,SAN,"San Diego, CA: San Diego International",341,114,227
2007,12,2007-12,DL,Delta Air Lines Inc.,SAN,"San Diego, CA: San Diego International",337,108,229
2007,12,2007-12,F9,Frontier Airlines Inc.,SAN,"San Diego, CA: San Diego International",163,65,98
2007,12,2007-12,FL,AirTran Airways Corporation,SAN,"San Diego, CA: San Diego International",59,33,26
2007,12,2007-12,HA,Hawaiian Airlines Inc.,SAN,"San Diego, CA: San Diego International",61,14,47
2007,12,2007-12,MQ,American Eagle Airlines Inc.,SAN,"San Diego, CA: San Diego International",769,132,637
2007,12,2007-12,NW,Northwest Airlines Inc.,SAN,"San Diego, CA: San Diego International",171,98,73
2007,12,2007-12,OO,SkyWest Airlines Inc.,SAN,"San Diego, CA: San Diego International",624,122,502
2007,12,2007-12,UA,United Air Lines Inc.,SAN,"San Diego, CA: San Diego International",706,308,398
2007,12,2007-12,US,US Airways Inc.,SAN,"San Diego, CA: San Diego International",468,123,345
2007,12,2007-12,WN,Southwest Airlines Co.,SAN,"San Diego, CA: San Diego International",2994,683,2311
2007,12,2007-12,XE,ExpressJet Airlines Inc.,SAN,"San Diego, CA: San Diego International",589,155,434
2007,12,2007-12,YV,Mesa Airlines Inc.,SAN,"San Diego, CA: San Diego International",22,7,15
2008,1,2008-01,AA,American Airlines Inc.,SAN,"San Diego, CA: San Diego International",519,191,328
2008,1,2008-01,AQ,Aloha Airlines Inc.,SAN,"San Diego, CA: San Diego International",43,12,31
2008,1,2008-01,AS,Alaska Airlines Inc.,SAN,"San Diego, CA: San Diego International",341,91,250
2008,1,2008-01,B6,JetBlue Airways,SAN,"San Diego, CA: San Diego International",151,28,123
2008,1,2008-01,CO,Continental Air Lines Inc.,SAN,"San Diego, CA: San Diego International",277,81,196
2008,1,2008-01,DL,Delta Air Lines Inc.,SAN,"San Diego, CA: San Diego International",359,120,239
2008,1,2008-01,F9,Frontier Airlines Inc.,SAN,"San Diego, CA: San Diego International",196,54,142
2008,1,2008-01,FL,AirTran Airways Corporation,SAN,"San Diego, CA: San Diego International",64,23,41
2008,1,2008-01,HA,Hawaiian Airlines Inc.,SAN,"San Diego, CA: San Diego International",62,5,57
2008,1,2008-01,MQ,American Eagle Airlines Inc.,SAN,"San Diego, CA: San Diego International",641,83,558
2008,1,2008-01,NW,Northwest Airlines Inc.,SAN,"San Diego, CA: San Diego International",126,55,71
2008,1,2008-01,OO,SkyWest Airlines Inc.,SAN,"San Diego, CA: San Diego International",537,136,401
2008,1,2008-01,UA,United Air Lines Inc.,SAN,"San Diego, CA: San Diego International",699,279,420
2008,1,2008-01,US,US Airways Inc.,SAN,"San Diego, CA: San Diego International",477,110,367
2008,1,2008-01,WN,Southwest Airlines Co.,SAN,"San Diego, CA: San Diego International",3046,784,2262
2008,1,2008-01,XE,ExpressJet Airlines Inc.,SAN,"San Diego, CA: San Diego International",485,110,375
2008,1,2008-01,YV,Mesa Airlines Inc.,SAN,"San Diego, CA: San Diego International",8,3,5
2008,2,2008-02,AA,American Airlines Inc.,SAN,"San Diego, CA: San Diego International",484,172,312
2008,2,2008-02,AQ,Aloha Airlines Inc.,SAN,"San Diego, CA: San Diego International",47,5,42
2008,2,2008-02,AS,Alaska Airlines Inc.,SAN,"San Diego, CA: San Diego International",316,58,258
2008,2,2008-02,B6,JetBlue Airways,SAN,"San Diego, CA: San Diego International",145,42,103
2008,2,2008-02,CO,Continental Air Lines Inc.,SAN,"San Diego, CA: San Diego International",261,72,189
2008,2,2008-02,DL,Delta Air Lines Inc.,SAN,"San Diego, CA: San Diego International",338,97,241
2008,2,2008-02,F9,Frontier Airlines Inc.,SAN,"San Diego, CA: San Diego International",192,48,144
2008,2,2008-02,FL,AirTran Airways Corporation,SAN,"San Diego, CA: San Diego International",60,32,28
2008,2,2008-02,HA,Hawaiian Airlines Inc.,SAN,"San Diego, CA: San Diego International",58,7,51
2008,2,2008-02,MQ,American Eagle Airlines Inc.,SAN,"San Diego, CA: San Diego International",595,69,526
2008,2,2008-02,NW,Northwest Airlines Inc.,SAN,"San Diego, CA: San Diego International",140,49,91
2008,2,2008-02,OO,SkyWest Airlines Inc.,SAN,"San Diego, CA: San Diego International",491,122,369
2008,2,2008-02,UA,United Air Lines Inc.,SAN,"San Diego, CA: San Diego International",672,234,438
2008,2,2008-02,US,US Airways Inc.,SAN,"San Diego, CA: San Diego International",433,90,343
2008,2,2008-02,WN,Southwest Airlines Co.,SAN,"San Diego, CA: San Diego International",2834,719,2115
2008,2,2008-02,XE,ExpressJet Airlines Inc.,SAN,"San Diego, CA: San Diego International",404,75,329
2008,2,2008-02,YV,Mesa Airlines Inc.,SAN,"San Diego, CA: San Diego International",8,0,8
2008,3,2008-03,AA,American Airlines Inc.,SAN,"San Diego, CA: San Diego International",517,172,345
2008,3,2008-03,AS,Alaska Airlines Inc.,SAN,"San Diego, CA: San Diego International",336,64,272
2008,3,2008-03,B6,JetBlue Airways,SAN,"San Diego, CA: San Diego International",155,50,105
2008,3,2008-03,CO,Continental Air Lines Inc.,SAN,"San Diego, CA: San Diego International",299,81,218
2008,3,2008-03,DL,Delta Air Lines Inc.,SAN,"San Diego, CA: San Diego International",362,92,270
2008,3,2008-03,F9,Frontier Airlines Inc.,SAN,"San Diego, CA: San Diego International",208,56,152
2008,3,2008-03,FL,AirTran Airways Corporation,SAN,"San Diego, CA: San Diego International",70,21,49
2008,3,2008-03,HA,Hawaiian Airlines Inc.,SAN,"San Diego, CA: San Diego International",62,7,55
2008,3,2008-03,MQ,American Eagle Airlines Inc.,SAN,"San Diego, CA: San Diego International",605,40,565
2008,3,2008-03,NW,Northwest Airlines Inc.,SAN,"San Diego, CA: San Diego International",176,62,114
2008,3,2008-03,OO,SkyWest Airlines Inc.,SAN,"San Diego, CA: San Diego International",547,75,472
2008,3,2008-03,UA,United Air Lines Inc.,SAN,"San Diego, CA: San Diego International",707,189,518
2008,3,2008-03,US,US Airways Inc.,SAN,"San Diego, CA: San Diego International",456,57,399
2008,3,2008-03,WN,Southwest Airlines Co.,SAN,"San Diego, CA: San Diego International",3083,682,2401
2008,3,2008-03,XE,ExpressJet Airlines Inc.,SAN,"San Diego, CA: San Diego International",487,65,422
2008,3,2008-03,YV,Mesa Airlines Inc.,SAN,"San Diego, CA: San Diego International",10,2,8
2008,4,2008-04,AA,American Airlines Inc.,SAN,"San Diego, CA: San Diego International",505,153,352
2008,4,2008-04,AS,Alaska Airlines Inc.,SAN,"San Diego, CA: San Diego International",326,55,271
2008,4,2008-04,B6,JetBlue Airways,SAN,"San Diego, CA: San Diego International",150,31,119
2008,4,2008-04,CO,Continental Air Lines Inc.,SAN,"San Diego, CA: San Diego International",288,95,193
2008,4,2008-04,DL,Delta Air Lines Inc.,SAN,"San Diego, CA: San Diego International",343,98,245
2008,4,2008-04,F9,Frontier Airlines Inc.,SAN,"San Diego, CA: San Diego International",186,42,144
2008,4,2008-04,FL,AirTran Airways Corporation,SAN,"San Diego, CA: San Diego International",61,18,43
2008,4,2008-04,HA,Hawaiian Airlines Inc.,SAN,"San Diego, CA: San Diego International",60,9,51
2008,4,2008-04,MQ,American Eagle Airlines Inc.,SAN,"San Diego, CA: San Diego International",635,39,596
2008,4,2008-04,NW,Northwest Airlines Inc.,SAN,"San Diego, CA: San Diego International",178,62,116
2008,4,2008-04,OO,SkyWest Airlines Inc.,SAN,"San Diego, CA: San Diego International",522,40,482
2008,4,2008-04,UA,United Air Lines Inc.,SAN,"San Diego, CA: San Diego International",718,231,487
2008,4,2008-04,US,US Airways Inc.,SAN,"San Diego, CA: San Diego International",434,68,366
2008,4,2008-04,WN,Southwest Airlines Co.,SAN,"San Diego, CA: San Diego International",3155,474,2681
2008,4,2008-04,XE,ExpressJet Airlines Inc.,SAN,"San Diego, CA: San Diego International",436,75,361
2008,4,2008-04,YV,Mesa Airlines Inc.,SAN,"San Diego, CA: San Diego International",8,1,7
2008,5,2008-05,AA,American Airlines Inc.,SAN,"San Diego, CA: San Diego International",520,207,313
2008,5,2008-05,AS,Alaska Airlines Inc.,SAN,"San Diego, CA: San Diego International",336,53,283
2008,5,2008-05,B6,JetBlue Airways,SAN,"San Diego, CA: San Diego International",200,75,125
2008,5,2008-05,CO,Continental Air Lines Inc.,SAN,"San Diego, CA: San Diego International",291,101,190
2008,5,2008-05,DL,Delta Air Lines Inc.,SAN,"San Diego, CA: San Diego International",336,94,242
2008,5,2008-05,F9,Frontier Airlines Inc.,SAN,"San Diego, CA: San Diego International",179,65,114
2008,5,2008-05,FL,AirTran Airways Corporation,SAN,"San Diego, CA: San Diego International",84,36,48
2008,5,2008-05,HA,Hawaiian Airlines Inc.,SAN,"San Diego, CA: San Diego International",62,26,36
2008,5,2008-05,MQ,American Eagle Airlines Inc.,SAN,"San Diego, CA: San Diego International",667,66,601
2008,5,2008-05,NW,Northwest Airlines Inc.,SAN,"San Diego, CA: San Diego International",216,103,113
2008,5,2008-05,OO,SkyWest Airlines Inc.,SAN,"San Diego, CA: San Diego International",550,72,478
2008,5,2008-05,UA,United Air Lines Inc.,SAN,"San Diego, CA: San Diego International",730,215,515
2008,5,2008-05,US,US Airways Inc.,SAN,"San Diego, CA: San Diego International",486,88,398
2008,5,2008-05,WN,Southwest Airlines Co.,SAN,"San Diego, CA: San Diego International",3245,717,2528
2008,5,2008-05,XE,ExpressJet Airlines Inc.,SAN,"San Diego, CA: San Diego International",438,76,362
2008,5,2008-05,YV,Mesa Airlines Inc.,SAN,"San Diego, CA: San Diego International",10,2,8
2008,6,2008-06,AA,American Airlines Inc.,SAN,"San Diego, CA: San Diego International",506,257,249
2008,6,2008-06,AS,Alaska Airlines Inc.,SAN,"San Diego, CA: San Diego International",348,47,301
2008,6,2008-06,B6,JetBlue Airways,SAN,"San Diego, CA: San Diego International",231,113,118
2008,6,2008-06,CO,Continental Air Lines Inc.,SAN,"San Diego, CA: San Diego International",347,117,230
2008,6,2008-06,DL,Delta Air Lines Inc.,SAN,"San Diego, CA: San Diego International",395,131,264
2008,6,2008-06,F9,Frontier Airlines Inc.,SAN,"San Diego, CA: San Diego International",176,61,115
2008,6,2008-06,FL,AirTran Airways Corporation,SAN,"San Diego, CA: San Diego International",120,37,83
2008,6,2008-06,HA,Hawaiian Airlines Inc.,SAN,"San Diego, CA: San Diego International",60,15,45
2008,6,2008-06,MQ,American Eagle Airlines Inc.,SAN,"San Diego, CA: San Diego International",647,73,574
2008,6,2008-06,NW,Northwest Airlines Inc.,SAN,"San Diego, CA: San Diego International",209,111,98
2008,6,2008-06,OO,SkyWest Airlines Inc.,SAN,"San Diego, CA: San Diego International",546,66,480
2008,6,2008-06,UA,United Air Lines Inc.,SAN,"San Diego, CA: San Diego International",704,301,403
2008,6,2008-06,US,US Airways Inc.,SAN,"San Diego, CA: San Diego International",451,110,341
2008,6,2008-06,WN,Southwest Airlines Co.,SAN,"San Diego, CA: San Diego International",3173,790,2383
2008,6,2008-06,XE,ExpressJet Airlines Inc.,SAN,"San Diego, CA: San Diego International",433,96,337
2008,6,2008-06,YV,Mesa Airlines Inc.,SAN,"San Diego, CA: San Diego International",4,0,4
2008,7,2008-07,AA,American Airlines Inc.,SAN,"San Diego, CA: San Diego International",519,140,379
2008,7,2008-07,AS,Alaska Airlines Inc.,SAN,"San Diego, CA: San Diego International",362,50,312
2008,7,2008-07,B6,JetBlue Airways,SAN,"San Diego, CA: San Diego International",245,64,181
2008,7,2008-07,CO,Continental Air Lines Inc.,SAN,"San Diego, CA: San Diego International",395,75,320
2008,7,2008-07,DL,Delta Air Lines Inc.,SAN,"San Diego, CA: San Diego International",405,89,316
2008,7,2008-07,F9,Frontier Airlines Inc.,SAN,"San Diego, CA: San Diego International",181,31,150
2008,7,2008-07,FL,AirTran Airways Corporation,SAN,"San Diego, CA: San Diego International",147,32,115
2008,7,2008-07,HA,Hawaiian Airlines Inc.,SAN,"San Diego, CA: San Diego International",62,20,42
2008,7,2008-07,MQ,American Eagle Airlines Inc.,SAN,"San Diego, CA: San Diego International",668,57,611
2008,7,2008-07,NW,Northwest Airlines Inc.,SAN,"San Diego, CA: San Diego International",217,49,168
2008,7,2008-07,OO,SkyWest Airlines Inc.,SAN,"San Diego, CA: San Diego International",547,42,505
2008,7,2008-07,UA,United Air Lines Inc.,SAN,"San Diego, CA: San Diego International",698,228,470
2008,7,2008-07,US,US Airways Inc.,SAN,"San Diego, CA: San Diego International",462,77,385
2008,7,2008-07,WN,Southwest Airlines Co.,SAN,"San Diego, CA: San Diego International",3258,492,2766
2008,7,2008-07,XE,ExpressJet Airlines Inc.,SAN,"San Diego, CA: San Diego International",443,68,375
2008,7,2008-07,YV,Mesa Airlines Inc.,SAN,"San Diego, CA: San Diego International",4,2,2
2008,8,2008-08,AA,American Airlines Inc.,SAN,"San Diego, CA: San Diego International",520,146,374
2008,8,2008-08,AS,Alaska Airlines Inc.,SAN,"San Diego, CA: San Diego International",348,65,283
2008,8,2008-08,B6,JetBlue Airways,SAN,"San Diego, CA: San Diego International",237,68,169
2008,8,2008-08,CO,Continental Air Lines Inc.,SAN,"San Diego, CA: San Diego International",392,97,295
2008,8,2008-08,DL,Delta Air Lines Inc.,SAN,"San Diego, CA: San Diego International",408,100,308
2008,8,2008-08,F9,Frontier Airlines Inc.,SAN,"San Diego, CA: San Diego International",181,25,156
2008,8,2008-08,FL,AirTran Airways Corporation,SAN,"San Diego, CA: San Diego International",135,32,103
2008,8,2008-08,HA,Hawaiian Airlines Inc.,SAN,"San Diego, CA: San Diego International",62,16,46
2008,8,2008-08,MQ,American Eagle Airlines Inc.,SAN,"San Diego, CA: San Diego International",663,50,613
2008,8,2008-08,NW,Northwest Airlines Inc.,SAN,"San Diego, CA: San Diego International",176,21,155
2008,8,2008-08,OO,SkyWest Airlines Inc.,SAN,"San Diego, CA: San Diego International",545,27,518
2008,8,2008-08,UA,United Air Lines Inc.,SAN,"San Diego, CA: San Diego International",675,201,474
2008,8,2008-08,US,US Airways Inc.,SAN,"San Diego, CA: San Diego International",430,78,352
2008,8,2008-08,WN,Southwest Airlines Co.,SAN,"San Diego, CA: San Diego International",3190,442,2748
2008,8,2008-08,XE,ExpressJet Airlines Inc.,SAN,"San Diego, CA: San Diego International",366,65,301
2008,8,2008-08,YV,Mesa Airlines Inc.,SAN,"San Diego, CA: San Diego International",18,4,14
2008,9,2008-09,AA,American Airlines Inc.,SAN,"San Diego, CA: San Diego International",476,79,397
2008,9,2008-09,AS,Alaska Airlines Inc.,SAN,"San Diego, CA: San Diego International",319,30,289
2008,9,2008-09,B6,JetBlue Airways,SAN,"San Diego, CA: San Diego International",174,29,145
2008,9,2008-09,CO,Continental Air Lines Inc.,SAN,"San Diego, CA: San Diego International",266,31,235
2008,9,2008-09,DL,Delta Air Lines Inc.,SAN,"San Diego, CA: San Diego International",332,43,289
2008,9,2008-09,F9,Frontier Airlines Inc.,SAN,"San Diego, CA: San Diego International",151,12,139
2008,9,2008-09,FL,AirTran Airways Corporation,SAN,"San Diego, CA: San Diego International",47,9,38
2008,9,2008-09,HA,Hawaiian Airlines Inc.,SAN,"San Diego, CA: San Diego International",31,4,27
2008,9,2008-09,MQ,American Eagle Airlines Inc.,SAN,"San Diego, CA: San Diego International",590,64,526
2008,9,2008-09,NW,Northwest Airlines Inc.,SAN,"San Diego, CA: San Diego International",120,11,109
2008,9,2008-09,OO,SkyWest Airlines Inc.,SAN,"San Diego, CA: San Diego International",538,39,499
2008,9,2008-09,UA,United Air Lines Inc.,SAN,"San Diego, CA: San Diego International",605,102,503
2008,9,2008-09,US,US Airways Inc.,SAN,"San Diego, CA: San Diego International",371,43,328
2008,9,2008-09,WN,Southwest Airlines Co.,SAN,"San Diego, CA: San Diego International",3078,211,2867
2008,9,2008-09,XE,ExpressJet Airlines Inc.,SAN,"San Diego, CA: San Diego International",7,0,7
2008,9,2008-09,YV,Mesa Airlines Inc.,SAN,"San Diego, CA: San Diego International",26,3,23
2008,10,2008-10,AA,American Airlines Inc.,SAN,"San Diego, CA: San Diego International",492,75,417
2008,10,2008-10,AS,Alaska Airlines Inc.,SAN,"San Diego, CA: San Diego International",333,33,300
2008,10,2008-10,B6,JetBlue Airways,SAN,"San Diego, CA: San Diego International",178,19,159
2008,10,2008-10,CO,Continental Air Lines Inc.,SAN,"San Diego, CA: San Diego International",272,52,220
2008,10,2008-10,DL,Delta Air Lines Inc.,SAN,"San Diego, CA: San Diego International",340,51,289
2008,10,2008-10,F9,Frontier Airlines Inc.,SAN,"San Diego, CA: San Diego International",155,17,138
2008,10,2008-10,FL,AirTran Airways Corporation,SAN,"San Diego, CA: San Diego International",44,10,34
2008,10,2008-10,HA,Hawaiian Airlines Inc.,SAN,"San Diego, CA: San Diego International",31,10,21
2008,10,2008-10,MQ,American Eagle Airlines Inc.,SAN,"San Diego, CA: San Diego International",608,46,562
2008,10,2008-10,NW,Northwest Airlines Inc.,SAN,"San Diego, CA: San Diego International",124,11,113
2008,10,2008-10,OO,SkyWest Airlines Inc.,SAN,"San Diego, CA: San Diego International",555,42,513
2008,10,2008-10,UA,United Air Lines Inc.,SAN,"San Diego, CA: San Diego International",627,69,558
2008,10,2008-10,US,US Airways Inc.,SAN,"San Diego, CA: San Diego International",379,46,333
2008,10,2008-10,WN,Southwest Airlines Co.,SAN,"San Diego, CA: San Diego International",3195,281,2914
2008,10,2008-10,YV,Mesa Airlines Inc.,SAN,"San Diego, CA: San Diego International",31,3,28
2008,11,2008-11,AA,American Airlines Inc.,SAN,"San Diego, CA: San Diego International",435,53,382
2008,11,2008-11,AS,Alaska Airlines Inc.,SAN,"San Diego, CA: San Diego International",294,58,236
2008,11,2008-11,B6,JetBlue Airways,SAN,"San Diego, CA: San Diego International",148,11,137
2008,11,2008-11,CO,Continental Air Lines Inc.,SAN,"San Diego, CA: San Diego International",259,26,233
2008,11,2008-11,DL,Delta Air Lines Inc.,SAN,"San Diego, CA: San Diego International",327,74,253
2008,11,2008-11,F9,Frontier Airlines Inc.,SAN,"San Diego, CA: San Diego International",145,15,130
2008,11,2008-11,FL,AirTran Airways Corporation,SAN,"San Diego, CA: San Diego International",30,7,23
2008,11,2008-11,HA,Hawaiian Airlines Inc.,SAN,"San Diego, CA: San Diego International",30,10,20
2008,11,2008-11,MQ,American Eagle Airlines Inc.,SAN,"San Diego, CA: San Diego International",585,72,513
2008,11,2008-11,NW,Northwest Airlines Inc.,SAN,"San Diego, CA: San Diego International",175,22,153
2008,11,2008-11,OO,SkyWest Airlines Inc.,SAN,"San Diego, CA: San Diego International",478,32,446
2008,11,2008-11,UA,United Air Lines Inc.,SAN,"San Diego, CA: San Diego International",569,66,503
2008,11,2008-11,US,US Airways Inc.,SAN,"San Diego, CA: San Diego International",378,64,314
2008,11,2008-11,WN,Southwest Airlines Co.,SAN,"San Diego, CA: San Diego International",3036,380,2656
2008,11,2008-11,YV,Mesa Airlines Inc.,SAN,"San Diego, CA: San Diego International",28,8,20
2008,12,2008-12,AA,American Airlines Inc.,SAN,"San Diego, CA: San Diego International",456,165,291
2008,12,2008-12,AS,Alaska Airlines Inc.,SAN,"San Diego, CA: San Diego International",301,91,210
2008,12,2008-12,B6,JetBlue Airways,SAN,"San Diego, CA: San Diego International",155,42,113
2008,12,2008-12,CO,Continental Air Lines Inc.,SAN,"San Diego, CA: San Diego International",309,111,198
2008,12,2008-12,DL,Delta Air Lines Inc.,SAN,"San Diego, CA: San Diego International",289,94,195
2008,12,2008-12,F9,Frontier Airlines Inc.,SAN,"San Diego, CA: San Diego International",152,78,74
2008,12,2008-12,FL,AirTran Airways Corporation,SAN,"San Diego, CA: San Diego International",31,14,17
2008,12,2008-12,HA,Hawaiian Airlines Inc.,SAN,"San Diego, CA: San Diego International",31,17,14
2008,12,2008-12,MQ,American Eagle Airlines Inc.,SAN,"San Diego, CA: San Diego International",606,110,496
2008,12,2008-12,NW,Northwest Airlines Inc.,SAN,"San Diego, CA: San Diego International",165,98,67
2008,12,2008-12,OO,SkyWest Airlines Inc.,SAN,"San Diego, CA: San Diego International",517,86,431
2008,12,2008-12,UA,United Air Lines Inc.,SAN,"San Diego, CA: San Diego International",604,207,397
2008,12,2008-12,US,US Airways Inc.,SAN,"San Diego, CA: San Diego International",379,116,263
2008,12,2008-12,WN,Southwest Airlines Co.,SAN,"San Diego, CA: San Diego International",3058,1025,2033
2008,12,2008-12,YV,Mesa Airlines Inc.,SAN,"San Diego, CA: San Diego International",32,11,21
2009,1,2009-01,AA,American Airlines Inc.,SAN,"San Diego, CA: San Diego International",455,120,335
2009,1,2009-01,AS,Alaska Airlines Inc.,SAN,"San Diego, CA: San Diego International",296,49,247
2009,1,2009-01,B6,JetBlue Airways,SAN,"San Diego, CA: San Diego International",155,27,128
2009,1,2009-01,CO,Continental Air Lines Inc.,SAN,"San Diego, CA: San Diego International",270,62,208
2009,1,2009-01,DL,Delta Air Lines Inc.,SAN,"San Diego, CA: San Diego International",275,49,226
2009,1,2009-01,F9,Frontier Airlines Inc.,SAN,"San Diego, CA: San Diego International",148,35,113
2009,1,2009-01,FL,AirTran Airways Corporation,SAN,"San Diego, CA: San Diego International",5,3,2
2009,1,2009-01,HA,Hawaiian Airlines Inc.,SAN,"San Diego, CA: San Diego International",31,16,15
2009,1,2009-01,MQ,American Eagle Airlines Inc.,SAN,"San Diego, CA: San Diego International",603,67,536
2009,1,2009-01,NW,Northwest Airlines Inc.,SAN,"San Diego, CA: San Diego International",125,37,88
2009,1,2009-01,OO,SkyWest Airlines Inc.,SAN,"San Diego, CA: San Diego International",584,59,525
2009,1,2009-01,UA,United Air Lines Inc.,SAN,"San Diego, CA: San Diego International",581,106,475
2009,1,2009-01,US,US Airways Inc.,SAN,"San Diego, CA: San Diego International",364,84,280
2009,1,2009-01,WN,Southwest Airlines Co.,SAN,"San Diego, CA: San Diego International",3000,403,2597
2009,1,2009-01,YV,Mesa Airlines Inc.,SAN,"San Diego, CA: San Diego International",27,10,17
2009,2,2009-02,AA,American Airlines Inc.,SAN,"San Diego, CA: San Diego International",412,119,293
2009,2,2009-02,AS,Alaska Airlines Inc.,SAN,"San Diego, CA: San Diego International",275,76,199
2009,2,2009-02,B6,JetBlue Airways,SAN,"San Diego, CA: San Diego International",140,20,120
2009,2,2009-02,CO,Continental Air Lines Inc.,SAN,"San Diego, CA: San Diego International",252,73,179
2009,2,2009-02,DL,Delta Air Lines Inc.,SAN,"San Diego, CA: San Diego International",247,54,193
2009,2,2009-02,F9,Frontier Airlines Inc.,SAN,"San Diego, CA: San Diego International",132,36,96
2009,2,2009-02,HA,Hawaiian Airlines Inc.,SAN,"San Diego, CA: San Diego International",28,10,18
2009,2,2009-02,MQ,American Eagle Airlines Inc.,SAN,"San Diego, CA: San Diego International",548,81,467
2009,2,2009-02,NW,Northwest Airlines Inc.,SAN,"San Diego, CA: San Diego International",142,58,84
2009,2,2009-02,OO,SkyWest Airlines Inc.,SAN,"San Diego, CA: San Diego International",545,59,486
2009,2,2009-02,UA,United Air Lines Inc.,SAN,"San Diego, CA: San Diego International",555,149,406
2009,2,2009-02,US,US Airways Inc.,SAN,"San Diego, CA: San Diego International",324,79,245
2009,2,2009-02,WN,Southwest Airlines Co.,SAN,"San Diego, CA: San Diego International",2698,442,2256
2009,2,2009-02,YV,Mesa Airlines Inc.,SAN,"San Diego, CA: San Diego International",27,1,26
2009,3,2009-03,AA,American Airlines Inc.,SAN,"San Diego, CA: San Diego International",457,142,315
2009,3,2009-03,AS,Alaska Airlines Inc.,SAN,"San Diego, CA: San Diego International",306,58,248
2009,3,2009-03,B6,JetBlue Airways,SAN,"San Diego, CA: San Diego International",155,21,134
2009,3,2009-03,CO,Continental Air Lines Inc.,SAN,"San Diego, CA: San Diego International",299,65,234
2009,3,2009-03,DL,Delta Air Lines Inc.,SAN,"San Diego, CA: San Diego International",296,66,230
2009,3,2009-03,F9,Frontier Airlines Inc.,SAN,"San Diego, CA: San Diego International",126,33,93
2009,3,2009-03,HA,Hawaiian Airlines Inc.,SAN,"San Diego, CA: San Diego International",31,14,17
2009,3,2009-03,MQ,American Eagle Airlines Inc.,SAN,"San Diego, CA: San Diego International",608,55,553
2009,3,2009-03,NW,Northwest Airlines Inc.,SAN,"San Diego, CA: San Diego International",177,63,114
2009,3,2009-03,OO,SkyWest Airlines Inc.,SAN,"San Diego, CA: San Diego International",586,53,533
2009,3,2009-03,UA,United Air Lines Inc.,SAN,"San Diego, CA: San Diego International",640,120,520
2009,3,2009-03,US,US Airways Inc.,SAN,"San Diego, CA: San Diego International",372,65,307
2009,3,2009-03,WN,Southwest Airlines Co.,SAN,"San Diego, CA: San Diego International",2998,513,2485
2009,3,2009-03,YV,Mesa Airlines Inc.,SAN,"San Diego, CA: San Diego International",1,0,1
2009,4,2009-04,AA,American Airlines Inc.,SAN,"San Diego, CA: San Diego International",470,119,351
2009,4,2009-04,AS,Alaska Airlines Inc.,SAN,"San Diego, CA: San Diego International",296,29,267
2009,4,2009-04,B6,JetBlue Airways,SAN,"San Diego, CA: San Diego International",150,18,132
2009,4,2009-04,CO,Continental Air Lines Inc.,SAN,"San Diego, CA: San Diego International",285,77,208
2009,4,2009-04,DL,Delta Air Lines Inc.,SAN,"San Diego, CA: San Diego International",283,60,223
2009,4,2009-04,F9,Frontier Airlines Inc.,SAN,"San Diego, CA: San Diego International",120,34,86
2009,4,2009-04,HA,Hawaiian Airlines Inc.,SAN,"San Diego, CA: San Diego International",30,9,21
2009,4,2009-04,MQ,American Eagle Airlines Inc.,SAN,"San Diego, CA: San Diego International",588,38,550
2009,4,2009-04,NW,Northwest Airlines Inc.,SAN,"San Diego, CA: San Diego International",178,27,151
2009,4,2009-04,OO,SkyWest Airlines Inc.,SAN,"San Diego, CA: San Diego International",571,24,547
2009,4,2009-04,UA,United Air Lines Inc.,SAN,"San Diego, CA: San Diego International",602,109,493
2009,4,2009-04,US,US Airways Inc.,SAN,"San Diego, CA: San Diego International",360,55,305
2009,4,2009-04,WN,Southwest Airlines Co.,SAN,"San Diego, CA: San Diego International",2891,475,2416
2009,5,2009-05,AA,American Airlines Inc.,SAN,"San Diego, CA: San Diego International",490,107,383
2009,5,2009-05,AS,Alaska Airlines Inc.,SAN,"San Diego, CA: San Diego International",305,33,272
2009,5,2009-05,B6,JetBlue Airways,SAN,"San Diego, CA: San Diego International",181,12,169
2009,5,2009-05,CO,Continental Air Lines Inc.,SAN,"San Diego, CA: San Diego International",286,35,251
2009,5,2009-05,DL,Delta Air Lines Inc.,SAN,"San Diego, CA: San Diego International",324,24,300
2009,5,2009-05,F9,Frontier Airlines Inc.,SAN,"San Diego, CA: San Diego International",145,21,124
2009,5,2009-05,FL,AirTran Airways Corporation,SAN,"San Diego, CA: San Diego International",42,3,39
2009,5,2009-05,HA,Hawaiian Airlines Inc.,SAN,"San Diego, CA: San Diego International",31,14,17
2009,5,2009-05,MQ,American Eagle Airlines Inc.,SAN,"San Diego, CA: San Diego International",605,64,541
2009,5,2009-05,NW,Northwest Airlines Inc.,SAN,"San Diego, CA: San Diego International",196,19,177
2009,5,2009-05,OO,SkyWest Airlines Inc.,SAN,"San Diego, CA: San Diego International",601,31,570
2009,5,2009-05,UA,United Air Lines Inc.,SAN,"San Diego, CA: San Diego International",616,120,496
2009,5,2009-05,US,US Airways Inc.,SAN,"San Diego, CA: San Diego International",392,54,338
2009,5,2009-05,WN,Southwest Airlines Co.,SAN,"San Diego, CA: San Diego International",2964,465,2499
2009,6,2009-06,AA,American Airlines Inc.,SAN,"San Diego, CA: San Diego International",479,183,296
2009,6,2009-06,AS,Alaska Airlines Inc.,SAN,"San Diego, CA: San Diego International",300,51,249
2009,6,2009-06,B6,JetBlue Airways,SAN,"San Diego, CA: San Diego International",180,27,153
2009,6,2009-06,CO,Continental Air Lines Inc.,SAN,"San Diego, CA: San Diego International",329,69,260
2009,6,2009-06,DL,Delta Air Lines Inc.,SAN,"San Diego, CA: San Diego International",377,117,260
2009,6,2009-06,F9,Frontier Airlines Inc.,SAN,"San Diego, CA: San Diego International",150,41,109
2009,6,2009-06,FL,AirTran Airways Corporation,SAN,"San Diego, CA: San Diego International",90,14,76
2009,6,2009-06,HA,Hawaiian Airlines Inc.,SAN,"San Diego, CA: San Diego International",30,19,11
2009,6,2009-06,MQ,American Eagle Airlines Inc.,SAN,"San Diego, CA: San Diego International",588,63,525
2009,6,2009-06,NW,Northwest Airlines Inc.,SAN,"San Diego, CA: San Diego International",204,83,121
2009,6,2009-06,OO,SkyWest Airlines Inc.,SAN,"San Diego, CA: San Diego International",580,57,523
2009,6,2009-06,UA,United Air Lines Inc.,SAN,"San Diego, CA: San Diego International",648,205,443
2009,6,2009-06,US,US Airways Inc.,SAN,"San Diego, CA: San Diego International",419,112,307
2009,6,2009-06,WN,Southwest Airlines Co.,SAN,"San Diego, CA: San Diego International",2922,714,2208
2009,7,2009-07,AA,American Airlines Inc.,SAN,"San Diego, CA: San Diego International",493,168,325
2009,7,2009-07,AS,Alaska Airlines Inc.,SAN,"San Diego, CA: San Diego International",308,33,275
2009,7,2009-07,B6,JetBlue Airways,SAN,"San Diego, CA: San Diego International",186,35,151
2009,7,2009-07,CO,Continental Air Lines Inc.,SAN,"San Diego, CA: San Diego International",362,74,288
2009,7,2009-07,DL,Delta Air Lines Inc.,SAN,"San Diego, CA: San Diego International",397,88,309
2009,7,2009-07,F9,Frontier Airlines Inc.,SAN,"San Diego, CA: San Diego International",155,31,124
2009,7,2009-07,FL,AirTran Airways Corporation,SAN,"San Diego, CA: San Diego International",93,12,81
2009,7,2009-07,HA,Hawaiian Airlines Inc.,SAN,"San Diego, CA: San Diego International",31,4,27
2009,7,2009-07,MQ,American Eagle Airlines Inc.,SAN,"San Diego, CA: San Diego International",607,63,544
2009,7,2009-07,NW,Northwest Airlines Inc.,SAN,"San Diego, CA: San Diego International",212,74,138
2009,7,2009-07,OO,SkyWest Airlines Inc.,SAN,"San Diego, CA: San Diego International",607,54,553
2009,7,2009-07,UA,United Air Lines Inc.,SAN,"San Diego, CA: San Diego International",664,122,542
2009,7,2009-07,US,US Airways Inc.,SAN,"San Diego, CA: San Diego International",435,90,345
2009,7,2009-07,WN,Southwest Airlines Co.,SAN,"San Diego, CA: San Diego International",3003,600,2403
2009,8,2009-08,AA,American Airlines Inc.,SAN,"San Diego, CA: San Diego International",496,132,364
2009,8,2009-08,AS,Alaska Airlines Inc.,SAN,"San Diego, CA: San Diego International",309,33,276
2009,8,2009-08,B6,JetBlue Airways,SAN,"San Diego, CA: San Diego International",186,28,158
2009,8,2009-08,CO,Continental Air Lines Inc.,SAN,"San Diego, CA: San Diego International",363,58,305
2009,8,2009-08,DL,Delta Air Lines Inc.,SAN,"San Diego, CA: San Diego International",391,66,325
2009,8,2009-08,F9,Frontier Airlines Inc.,SAN,"San Diego, CA: San Diego International",145,19,126
2009,8,2009-08,FL,AirTran Airways Corporation,SAN,"San Diego, CA: San Diego International",79,8,71
2009,8,2009-08,HA,Hawaiian Airlines Inc.,SAN,"San Diego, CA: San Diego International",31,10,21
2009,8,2009-08,MQ,American Eagle Airlines Inc.,SAN,"San Diego, CA: San Diego International",593,46,547
2009,8,2009-08,NW,Northwest Airlines Inc.,SAN,"San Diego, CA: San Diego International",192,52,140
2009,8,2009-08,OO,SkyWest Airlines Inc.,SAN,"San Diego, CA: San Diego International",621,45,576
2009,8,2009-08,UA,United Air Lines Inc.,SAN,"San Diego, CA: San Diego International",665,111,554
2009,8,2009-08,US,US Airways Inc.,SAN,"San Diego, CA: San Diego International",420,72,348
2009,8,2009-08,WN,Southwest Airlines Co.,SAN,"San Diego, CA: San Diego International",2891,448,2443
2009,9,2009-09,AA,American Airlines Inc.,SAN,"San Diego, CA: San Diego International",477,66,411
2009,9,2009-09,AS,Alaska Airlines Inc.,SAN,"San Diego, CA: San Diego International",294,19,275
2009,9,2009-09,B6,JetBlue Airways,SAN,"San Diego, CA: San Diego International",145,9,136
2009,9,2009-09,CO,Continental Air Lines Inc.,SAN,"San Diego, CA: San Diego International",252,34,218
2009,9,2009-09,DL,Delta Air Lines Inc.,SAN,"San Diego, CA: San Diego International",360,48,312
2009,9,2009-09,F9,Frontier Airlines Inc.,SAN,"San Diego, CA: San Diego International",136,8,128
2009,9,2009-09,FL,AirTran Airways Corporation,SAN,"San Diego, CA: San Diego International",37,13,24
2009,9,2009-09,HA,Hawaiian Airlines Inc.,SAN,"San Diego, CA: San Diego International",30,13,17
2009,9,2009-09,MQ,American Eagle Airlines Inc.,SAN,"San Diego, CA: San Diego International",533,31,502
2009,9,2009-09,NW,Northwest Airlines Inc.,SAN,"San Diego, CA: San Diego International",125,17,108
2009,9,2009-09,OO,SkyWest Airlines Inc.,SAN,"San Diego, CA: San Diego International",567,42,525
2009,9,2009-09,UA,United Air Lines Inc.,SAN,"San Diego, CA: San Diego International",607,55,552
2009,9,2009-09,US,US Airways Inc.,SAN,"San Diego, CA: San Diego International",380,40,340
2009,9,2009-09,WN,Southwest Airlines Co.,SAN,"San Diego, CA: San Diego International",2693,269,2424
2009,10,2009-10,AA,American Airlines Inc.,SAN,"San Diego, CA: San Diego International",496,160,336
2009,10,2009-10,AS,Alaska Airlines Inc.,SAN,"San Diego, CA: San Diego International",305,26,279
2009,10,2009-10,B6,JetBlue Airways,SAN,"San Diego, CA: San Diego International",137,41,96
2009,10,2009-10,CO,Continental Air Lines Inc.,SAN,"San Diego, CA: San Diego International",271,106,165
2009,10,2009-10,DL,Delta Air Lines Inc.,SAN,"San Diego, CA: San Diego International",345,77,268
2009,10,2009-10,F9,Frontier Airlines Inc.,SAN,"San Diego, CA: San Diego International",142,40,102
2009,10,2009-10,FL,AirTran Airways Corporation,SAN,"San Diego, CA: San Diego International",30,14,16
2009,10,2009-10,HA,Hawaiian Airlines Inc.,SAN,"San Diego, CA: San Diego International",31,7,24
2009,10,2009-10,MQ,American Eagle Airlines Inc.,SAN,"San Diego, CA: San Diego International",553,52,501
2009,10,2009-10,NW,Northwest Airlines Inc.,SAN,"San Diego, CA: San Diego International",133,56,77
2009,10,2009-10,OO,SkyWest Airlines Inc.,SAN,"San Diego, CA: San Diego International",581,84,497
2009,10,2009-10,UA,United Air Lines Inc.,SAN,"San Diego, CA: San Diego International",623,112,511
2009,10,2009-10,US,US Airways Inc.,SAN,"San Diego, CA: San Diego International",302,67,235
2009,10,2009-10,WN,Southwest Airlines Co.,SAN,"San Diego, CA: San Diego International",2792,707,2085
2009,10,2009-10,YV,Mesa Airlines Inc.,SAN,"San Diego, CA: San Diego International",91,6,85
2009,11,2009-11,AA,American Airlines Inc.,SAN,"San Diego, CA: San Diego International",446,58,388
2009,11,2009-11,AS,Alaska Airlines Inc.,SAN,"San Diego, CA: San Diego International",275,17,258
2009,11,2009-11,B6,JetBlue Airways,SAN,"San Diego, CA: San Diego International",88,3,85
2009,11,2009-11,CO,Continental Air Lines Inc.,SAN,"San Diego, CA: San Diego International",261,28,233
2009,11,2009-11,DL,Delta Air Lines Inc.,SAN,"San Diego, CA: San Diego International",300,9,291
2009,11,2009-11,F9,Frontier Airlines Inc.,SAN,"San Diego, CA: San Diego International",91,14,77
2009,11,2009-11,HA,Hawaiian Airlines Inc.,SAN,"San Diego, CA: San Diego International",30,6,24
2009,11,2009-11,MQ,American Eagle Airlines Inc.,SAN,"San Diego, CA: San Diego International",514,54,460
2009,11,2009-11,NW,Northwest Airlines Inc.,SAN,"San Diego, CA: San Diego International",161,7,154
2009,11,2009-11,OO,SkyWest Airlines Inc.,SAN,"San Diego, CA: San Diego International",573,67,506
2009,11,2009-11,UA,United Air Lines Inc.,SAN,"San Diego, CA: San Diego International",563,40,523
2009,11,2009-11,US,US Airways Inc.,SAN,"San Diego, CA: San Diego International",291,16,275
2009,11,2009-11,WN,Southwest Airlines Co.,SAN,"San Diego, CA: San Diego International",2690,182,2508
2009,11,2009-11,YV,Mesa Airlines Inc.,SAN,"San Diego, CA: San Diego International",88,7,81
2009,12,2009-12,AA,American Airlines Inc.,SAN,"San Diego, CA: San Diego International",433,122,311
2009,12,2009-12,AS,Alaska Airlines Inc.,SAN,"San Diego, CA: San Diego International",281,25,256
2009,12,2009-12,B6,JetBlue Airways,SAN,"San Diego, CA: San Diego International",91,30,61
2009,12,2009-12,CO,Continental Air Lines Inc.,SAN,"San Diego, CA: San Diego International",323,95,228
2009,12,2009-12,DL,Delta Air Lines Inc.,SAN,"San Diego, CA: San Diego International",276,59,217
2009,12,2009-12,F9,Frontier Airlines Inc.,SAN,"San Diego, CA: San Diego International",88,33,55
2009,12,2009-12,HA,Hawaiian Airlines Inc.,SAN,"San Diego, CA: San Diego International",31,2,29
2009,12,2009-12,MQ,American Eagle Airlines Inc.,SAN,"San Diego, CA: San Diego International",511,64,447
2009,12,2009-12,NW,Northwest Airlines Inc.,SAN,"San Diego, CA: San Diego International",156,34,122
2009,12,2009-12,OO,SkyWest Airlines Inc.,SAN,"San Diego, CA: San Diego International",597,127,470
2009,12,2009-12,UA,United Air Lines Inc.,SAN,"San Diego, CA: San Diego International",582,123,459
2009,12,2009-12,US,US Airways Inc.,SAN,"San Diego, CA: San Diego International",325,93,232
2009,12,2009-12,WN,Southwest Airlines Co.,SAN,"San Diego, CA: San Diego International",2774,713,2061
2009,12,2009-12,YV,Mesa Airlines Inc.,SAN,"San Diego, CA: San Diego International",93,10,83
2010,1,2010-01,AA,American Airlines Inc.,SAN,"San Diego, CA: San Diego International",434,94,340
2010,1,2010-01,AS,Alaska Airlines Inc.,SAN,"San Diego, CA: San Diego International",277,26,251
2010,1,2010-01,B6,JetBlue Airways,SAN,"San Diego, CA: San Diego International",92,9,83
2010,1,2010-01,CO,Continental Air Lines Inc.,SAN,"San Diego, CA: San Diego International",274,40,234
2010,1,2010-01,DL,Delta Air Lines Inc.,SAN,"San Diego, CA: San Diego International",386,57,329
2010,1,2010-01,F9,Frontier Airlines Inc.,SAN,"San Diego, CA: San Diego International",86,8,78
2010,1,2010-01,HA,Hawaiian Airlines Inc.,SAN,"San Diego, CA: San Diego International",31,6,25
2010,1,2010-01,MQ,American Eagle Airlines Inc.,SAN,"San Diego, CA: San Diego International",512,61,451
2010,1,2010-01,OO,SkyWest Airlines Inc.,SAN,"San Diego, CA: San Diego International",626,118,508
2010,1,2010-01,UA,United Air Lines Inc.,SAN,"San Diego, CA: San Diego International",581,71,510
2010,1,2010-01,US,US Airways Inc.,SAN,"San Diego, CA: San Diego International",283,52,231
2010,1,2010-01,WN,Southwest Airlines Co.,SAN,"San Diego, CA: San Diego International",2748,421,2327
2010,1,2010-01,YV,Mesa Airlines Inc.,SAN,"San Diego, CA: San Diego International",8,0,8
2010,2,2010-02,AA,American Airlines Inc.,SAN,"San Diego, CA: San Diego International",391,82,309
2010,2,2010-02,AS,Alaska Airlines Inc.,SAN,"San Diego, CA: San Diego International",248,19,229
2010,2,2010-02,B6,JetBlue Airways,SAN,"San Diego, CA: San Diego International",81,11,70
2010,2,2010-02,CO,Continental Air Lines Inc.,SAN,"San Diego, CA: San Diego International",247,65,182
2010,2,2010-02,DL,Delta Air Lines Inc.,SAN,"San Diego, CA: San Diego International",390,57,333
2010,2,2010-02,F9,Frontier Airlines Inc.,SAN,"San Diego, CA: San Diego International",80,16,64
2010,2,2010-02,HA,Hawaiian Airlines Inc.,SAN,"San Diego, CA: San Diego International",28,5,23
2010,2,2010-02,MQ,American Eagle Airlines Inc.,SAN,"San Diego, CA: San Diego International",464,42,422
2010,2,2010-02,OO,SkyWest Airlines Inc.,SAN,"San Diego, CA: San Diego International",624,95,529
2010,2,2010-02,UA,United Air Lines Inc.,SAN,"San Diego, CA: San Diego International",520,71,449
2010,2,2010-02,US,US Airways Inc.,SAN,"San Diego, CA: San Diego International",251,30,221
2010,2,2010-02,WN,Southwest Airlines Co.,SAN,"San Diego, CA: San Diego International",2519,333,2186
2010,3,2010-03,AA,American Airlines Inc.,SAN,"San Diego, CA: San Diego International",434,69,365
2010,3,2010-03,AS,Alaska Airlines Inc.,SAN,"San Diego, CA: San Diego International",293,28,265
2010,3,2010-03,B6,JetBlue Airways,SAN,"San Diego, CA: San Diego International",89,8,81
2010,3,2010-03,CO,Continental Air Lines Inc.,SAN,"San Diego, CA: San Diego International",273,67,206
2010,3,2010-03,DL,Delta Air Lines Inc.,SAN,"San Diego, CA: San Diego International",465,48,417
2010,3,2010-03,F9,Frontier Airlines Inc.,SAN,"San Diego, CA: San Diego International",88,23,65
2010,3,2010-03,HA,Hawaiian Airlines Inc.,SAN,"San Diego, CA: San Diego International",31,5,26
2010,3,2010-03,MQ,American Eagle Airlines Inc.,SAN,"San Diego, CA: San Diego International",515,19,496
2010,3,2010-03,OO,SkyWest Airlines Inc.,SAN,"San Diego, CA: San Diego International",725,101,624
2010,3,2010-03,UA,United Air Lines Inc.,SAN,"San Diego, CA: San Diego International",579,74,505
2010,3,2010-03,US,US Airways Inc.,SAN,"San Diego, CA: San Diego International",279,28,251
2010,3,2010-03,WN,Southwest Airlines Co.,SAN,"San Diego, CA: San Diego International",2842,476,2366
2010,3,2010-03,YV,Mesa Airlines Inc.,SAN,"San Diego, CA: San Diego International",2,1,1
2010,4,2010-04,AA,American Airlines Inc.,SAN,"San Diego, CA: San Diego International",420,64,356
2010,4,2010-04,AS,Alaska Airlines Inc.,SAN,"San Diego, CA: San Diego International",296,10,286
2010,4,2010-04,B6,JetBlue Airways,SAN,"San Diego, CA: San Diego International",86,10,76
2010,4,2010-04,CO,Continental Air Lines Inc.,SAN,"San Diego, CA: San Diego International",271,51,220
2010,4,2010-04,DL,Delta Air Lines Inc.,SAN,"San Diego, CA: San Diego International",525,88,437
2010,4,2010-04,F9,Frontier Airlines Inc.,SAN,"San Diego, CA: San Diego International",106,15,91
2010,4,2010-04,HA,Hawaiian Airlines Inc.,SAN,"San Diego, CA: San Diego International",30,8,22
2010,4,2010-04,MQ,American Eagle Airlines Inc.,SAN,"San Diego, CA: San Diego International",498,34,464
2010,4,2010-04,OO,SkyWest Airlines Inc.,SAN,"San Diego, CA: San Diego International",630,82,548
2010,4,2010-04,UA,United Air Lines Inc.,SAN,"San Diego, CA: San Diego International",581,75,506
2010,4,2010-04,US,US Airways Inc.,SAN,"San Diego, CA: San Diego International",289,32,257
2010,4,2010-04,WN,Southwest Airlines Co.,SAN,"San Diego, CA: San Diego International",2758,458,2300
2010,4,2010-04,YV,Mesa Airlines Inc.,SAN,"San Diego, CA: San Diego International",3,2,1
2010,5,2010-05,AA,American Airlines Inc.,SAN,"San Diego, CA: San Diego International",432,109,323
2010,5,2010-05,AS,Alaska Airlines Inc.,SAN,"San Diego, CA: San Diego International",305,20,285
2010,5,2010-05,B6,JetBlue Airways,SAN,"San Diego, CA: San Diego International",120,18,102
2010,5,2010-05,CO,Continental Air Lines Inc.,SAN,"San Diego, CA: San Diego International",273,55,218
2010,5,2010-05,DL,Delta Air Lines Inc.,SAN,"San Diego, CA: San Diego International",621,138,483
2010,5,2010-05,F9,Frontier Airlines Inc.,SAN,"San Diego, CA: San Diego International",153,30,123
2010,5,2010-05,FL,AirTran Airways Corporation,SAN,"San Diego, CA: San Diego International",10,1,9
2010,5,2010-05,HA,Hawaiian Airlines Inc.,SAN,"San Diego, CA: San Diego International",31,16,15
2010,5,2010-05,MQ,American Eagle Airlines Inc.,SAN,"San Diego, CA: San Diego International",510,39,471
2010,5,2010-05,OO,SkyWest Airlines Inc.,SAN,"San Diego, CA: San Diego International",649,63,586
2010,5,2010-05,UA,United Air Lines Inc.,SAN,"San Diego, CA: San Diego International",611,93,518
2010,5,2010-05,US,US Airways Inc.,SAN,"San Diego, CA: San Diego International",335,44,291
2010,5,2010-05,WN,Southwest Airlines Co.,SAN,"San Diego, CA: San Diego International",2886,558,2328
2010,5,2010-05,YV,Mesa Airlines Inc.,SAN,"San Diego, CA: San Diego International",17,1,16
2010,6,2010-06,AA,American Airlines Inc.,SAN,"San Diego, CA: San Diego International",420,118,302
2010,6,2010-06,AS,Alaska Airlines Inc.,SAN,"San Diego, CA: San Diego International",299,20,279
2010,6,2010-06,B6,JetBlue Airways,SAN,"San Diego, CA: San Diego International",118,9,109
2010,6,2010-06,CO,Continental Air Lines Inc.,SAN,"San Diego, CA: San Diego International",325,59,266
2010,6,2010-06,DL,Delta Air Lines Inc.,SAN,"San Diego, CA: San Diego International",671,202,469
2010,6,2010-06,F9,Frontier Airlines Inc.,SAN,"San Diego, CA: San Diego International",177,31,146
2010,6,2010-06,FL,AirTran Airways Corporation,SAN,"San Diego, CA: San Diego International",60,19,41
2010,6,2010-06,HA,Hawaiian Airlines Inc.,SAN,"San Diego, CA: San Diego International",44,12,32
2010,6,2010-06,MQ,American Eagle Airlines Inc.,SAN,"San Diego, CA: San Diego International",417,42,375
2010,6,2010-06,OO,SkyWest Airlines Inc.,SAN,"San Diego, CA: San Diego International",660,106,554
2010,6,2010-06,UA,United Air Lines Inc.,SAN,"San Diego, CA: San Diego International",564,117,447
2010,6,2010-06,US,US Airways Inc.,SAN,"San Diego, CA: San Diego International",330,62,268
2010,6,2010-06,WN,Southwest Airlines Co.,SAN,"San Diego, CA: San Diego International",2866,505,2361
2010,6,2010-06,YV,Mesa Airlines Inc.,SAN,"San Diego, CA: San Diego International",30,2,28
2010,7,2010-07,AA,American Airlines Inc.,SAN,"San Diego, CA: San Diego International",431,115,316
2010,7,2010-07,AS,Alaska Airlines Inc.,SAN,"San Diego, CA: San Diego International",310,18,292
2010,7,2010-07,B6,JetBlue Airways,SAN,"San Diego, CA: San Diego International",124,26,98
2010,7,2010-07,CO,Continental Air Lines Inc.,SAN,"San Diego, CA: San Diego International",359,63,296
2010,7,2010-07,DL,Delta Air Lines Inc.,SAN,"San Diego, CA: San Diego International",684,167,517
2010,7,2010-07,F9,Frontier Airlines Inc.,SAN,"San Diego, CA: San Diego International",184,28,156
2010,7,2010-07,FL,AirTran Airways Corporation,SAN,"San Diego, CA: San Diego International",62,13,49
2010,7,2010-07,HA,Hawaiian Airlines Inc.,SAN,"San Diego, CA: San Diego International",62,3,59
2010,7,2010-07,MQ,American Eagle Airlines Inc.,SAN,"San Diego, CA: San Diego International",393,49,344
2010,7,2010-07,OO,SkyWest Airlines Inc.,SAN,"San Diego, CA: San Diego International",657,139,518
2010,7,2010-07,UA,United Air Lines Inc.,SAN,"San Diego, CA: San Diego International",582,87,495
2010,7,2010-07,US,US Airways Inc.,SAN,"San Diego, CA: San Diego International",346,56,290
2010,7,2010-07,WN,Southwest Airlines Co.,SAN,"San Diego, CA: San Diego International",2909,539,2370
2010,7,2010-07,YV,Mesa Airlines Inc.,SAN,"San Diego, CA: San Diego International",30,3,27
2010,8,2010-08,AA,American Airlines Inc.,SAN,"San Diego, CA: San Diego International",433,67,366
2010,8,2010-08,AS,Alaska Airlines Inc.,SAN,"San Diego, CA: San Diego International",300,16,284
2010,8,2010-08,B6,JetBlue Airways,SAN,"San Diego, CA: San Diego International",124,26,98
2010,8,2010-08,CO,Continental Air Lines Inc.,SAN,"San Diego, CA: San Diego International",326,20,306
2010,8,2010-08,DL,Delta Air Lines Inc.,SAN,"San Diego, CA: San Diego International",628,122,506
2010,8,2010-08,F9,Frontier Airlines Inc.,SAN,"San Diego, CA: San Diego International",185,29,156
2010,8,2010-08,FL,AirTran Airways Corporation,SAN,"San Diego, CA: San Diego International",62,11,51
2010,8,2010-08,HA,Hawaiian Airlines Inc.,SAN,"San Diego, CA: San Diego International",54,8,46
2010,8,2010-08,MQ,American Eagle Airlines Inc.,SAN,"San Diego, CA: San Diego International",387,41,346
2010,8,2010-08,OO,SkyWest Airlines Inc.,SAN,"San Diego, CA: San Diego International",644,99,545
2010,8,2010-08,UA,United Air Lines Inc.,SAN,"San Diego, CA: San Diego International",623,82,541
2010,8,2010-08,US,US Airways Inc.,SAN,"San Diego, CA: San Diego International",341,38,303
2010,8,2010-08,WN,Southwest Airlines Co.,SAN,"San Diego, CA: San Diego International",2866,435,2431
2010,8,2010-08,YV,Mesa Airlines Inc.,SAN,"San Diego, CA: San Diego International",18,1,17
2010,9,2010-09,AA,American Airlines Inc.,SAN,"San Diego, CA: San Diego International",414,71,343
2010,9,2010-09,AS,Alaska Airlines Inc.,SAN,"San Diego, CA: San Diego International",269,19,250
2010,9,2010-09,B6,JetBlue Airways,SAN,"San Diego, CA: San Diego International",114,19,95
2010,9,2010-09,CO,Continental Air Lines Inc.,SAN,"San Diego, CA: San Diego International",250,18,232
2010,9,2010-09,DL,Delta Air Lines Inc.,SAN,"San Diego, CA: San Diego International",543,113,430
2010,9,2010-09,F9,Frontier Airlines Inc.,SAN,"San Diego, CA: San Diego International",135,12,123
2010,9,2010-09,FL,AirTran Airways Corporation,SAN,"San Diego, CA: San Diego International",13,1,12
2010,9,2010-09,HA,Hawaiian Airlines Inc.,SAN,"San Diego, CA: San Diego International",30,2,28
2010,9,2010-09,MQ,American Eagle Airlines Inc.,SAN,"San Diego, CA: San Diego International",352,38,314
2010,9,2010-09,OO,SkyWest Airlines Inc.,SAN,"San Diego, CA: San Diego International",562,64,498
2010,9,2010-09,UA,United Air Lines Inc.,SAN,"San Diego, CA: San Diego International",587,47,540
2010,9,2010-09,US,US Airways Inc.,SAN,"San Diego, CA: San Diego International",306,32,274
2010,9,2010-09,WN,Southwest Airlines Co.,SAN,"San Diego, CA: San Diego International",2678,384,2294
2010,9,2010-09,YV,Mesa Airlines Inc.,SAN,"San Diego, CA: San Diego International",9,0,9
2010,10,2010-10,AA,American Airlines Inc.,SAN,"San Diego, CA: San Diego International",429,68,361
2010,10,2010-10,AS,Alaska Airlines Inc.,SAN,"San Diego, CA: San Diego International",310,29,281
2010,10,2010-10,B6,JetBlue Airways,SAN,"San Diego, CA: San Diego International",123,25,98
2010,10,2010-10,CO,Continental Air Lines Inc.,SAN,"San Diego, CA: San Diego International",265,22,243
2010,10,2010-10,DL,Delta Air Lines Inc.,SAN,"San Diego, CA: San Diego International",545,90,455
2010,10,2010-10,F9,Frontier Airlines Inc.,SAN,"San Diego, CA: San Diego International",141,14,127
2010,10,2010-10,HA,Hawaiian Airlines Inc.,SAN,"San Diego, CA: San Diego International",31,9,22
2010,10,2010-10,MQ,American Eagle Airlines Inc.,SAN,"San Diego, CA: San Diego International",362,44,318
2010,10,2010-10,OO,SkyWest Airlines Inc.,SAN,"San Diego, CA: San Diego International",589,103,486
2010,10,2010-10,UA,United Air Lines Inc.,SAN,"San Diego, CA: San Diego International",627,54,573
2010,10,2010-10,US,US Airways Inc.,SAN,"San Diego, CA: San Diego International",310,55,255
2010,10,2010-10,WN,Southwest Airlines Co.,SAN,"San Diego, CA: San Diego International",2780,653,2127
2010,10,2010-10,YV,Mesa Airlines Inc.,SAN,"San Diego, CA: San Diego International",9,3,6
2010,11,2010-11,AA,American Airlines Inc.,SAN,"San Diego, CA: San Diego International",411,81,330
2010,11,2010-11,AS,Alaska Airlines Inc.,SAN,"San Diego, CA: San Diego International",315,47,268
2010,11,2010-11,B6,JetBlue Airways,SAN,"San Diego, CA: San Diego International",95,23,72
2010,11,2010-11,CO,Continental Air Lines Inc.,SAN,"San Diego, CA: San Diego International",251,36,215
2010,11,2010-11,DL,Delta Air Lines Inc.,SAN,"San Diego, CA: San Diego International",488,128,360
2010,11,2010-11,F9,Frontier Airlines Inc.,SAN,"San Diego, CA: San Diego International",128,20,108
2010,11,2010-11,HA,Hawaiian Airlines Inc.,SAN,"San Diego, CA: San Diego International",30,8,22
2010,11,2010-11,MQ,American Eagle Airlines Inc.,SAN,"San Diego, CA: San Diego International",349,27,322
2010,11,2010-11,OO,SkyWest Airlines Inc.,SAN,"San Diego, CA: San Diego International",578,105,473
2010,11,2010-11,UA,United Air Lines Inc.,SAN,"San Diego, CA: San Diego International",569,63,506
2010,11,2010-11,US,US Airways Inc.,SAN,"San Diego, CA: San Diego International",301,41,260
2010,11,2010-11,WN,Southwest Airlines Co.,SAN,"San Diego, CA: San Diego International",2634,557,2077
2010,12,2010-12,AA,American Airlines Inc.,SAN,"San Diego, CA: San Diego International",429,74,355
2010,12,2010-12,AS,Alaska Airlines Inc.,SAN,"San Diego, CA: San Diego International",320,81,239
2010,12,2010-12,B6,JetBlue Airways,SAN,"San Diego, CA: San Diego International",90,30,60
2010,12,2010-12,CO,Continental Air Lines Inc.,SAN,"San Diego, CA: San Diego International",327,100,227
2010,12,2010-12,DL,Delta Air Lines Inc.,SAN,"San Diego, CA: San Diego International",481,147,334
2010,12,2010-12,F9,Frontier Airlines Inc.,SAN,"San Diego, CA: San Diego International",131,41,90
2010,12,2010-12,HA,Hawaiian Airlines Inc.,SAN,"San Diego, CA: San Diego International",31,2,29
2010,12,2010-12,MQ,American Eagle Airlines Inc.,SAN,"San Diego, CA: San Diego International",362,75,287
2010,12,2010-12,OO,SkyWest Airlines Inc.,SAN,"San Diego, CA: San Diego International",617,219,398
2010,12,2010-12,UA,United Air Lines Inc.,SAN,"San Diego, CA: San Diego International",578,89,489
2010,12,2010-12,US,US Airways Inc.,SAN,"San Diego, CA: San Diego International",314,85,229
2010,12,2010-12,WN,Southwest Airlines Co.,SAN,"San Diego, CA: San Diego International",2692,998,1694
2011,1,2011-01,AA,American Airlines Inc.,SAN,"San Diego, CA: San Diego International",433,82,351
2011,1,2011-01,AS,Alaska Airlines Inc.,SAN,"San Diego, CA: San Diego International",331,42,289
2011,1,2011-01,B6,JetBlue Airways,SAN,"San Diego, CA: San Diego International",84,24,60
2011,1,2011-01,CO,Continental Air Lines Inc.,SAN,"San Diego, CA: San Diego International",265,64,201
2011,1,2011-01,DL,Delta Air Lines Inc.,SAN,"San Diego, CA: San Diego International",439,95,344
2011,1,2011-01,F9,Frontier Airlines Inc.,SAN,"San Diego, CA: San Diego International",118,27,91
2011,1,2011-01,HA,Hawaiian Airlines Inc.,SAN,"San Diego, CA: San Diego International",31,17,14
2011,1,2011-01,MQ,American Eagle Airlines Inc.,SAN,"San Diego, CA: San Diego International",362,36,326
2011,1,2011-01,OO,SkyWest Airlines Inc.,SAN,"San Diego, CA: San Diego International",623,97,526
2011,1,2011-01,UA,United Air Lines Inc.,SAN,"San Diego, CA: San Diego International",592,72,520
2011,1,2011-01,US,US Airways Inc.,SAN,"San Diego, CA: San Diego International",287,53,234
2011,1,2011-01,WN,Southwest Airlines Co.,SAN,"San Diego, CA: San Diego International",2729,621,2108
2011,2,2011-02,AA,American Airlines Inc.,SAN,"San Diego, CA: San Diego International",390,149,241
2011,2,2011-02,AS,Alaska Airlines Inc.,SAN,"San Diego, CA: San Diego International",300,58,242
2011,2,2011-02,B6,JetBlue Airways,SAN,"San Diego, CA: San Diego International",80,32,48
2011,2,2011-02,CO,Continental Air Lines Inc.,SAN,"San Diego, CA: San Diego International",239,65,174
2011,2,2011-02,DL,Delta Air Lines Inc.,SAN,"San Diego, CA: San Diego International",390,88,302
2011,2,2011-02,F9,Frontier Airlines Inc.,SAN,"San Diego, CA: San Diego International",121,37,84
2011,2,2011-02,HA,Hawaiian Airlines Inc.,SAN,"San Diego, CA: San Diego International",28,9,19
2011,2,2011-02,MQ,American Eagle Airlines Inc.,SAN,"San Diego, CA: San Diego International",328,45,283
2011,2,2011-02,OO,SkyWest Airlines Inc.,SAN,"San Diego, CA: San Diego International",596,122,474
2011,2,2011-02,UA,United Air Lines Inc.,SAN,"San Diego, CA: San Diego International",509,117,392
2011,2,2011-02,US,US Airways Inc.,SAN,"San Diego, CA: San Diego International",256,61,195
2011,2,2011-02,WN,Southwest Airlines Co.,SAN,"San Diego, CA: San Diego International",2500,619,1881
2011,3,2011-03,AA,American Airlines Inc.,SAN,"San Diego, CA: San Diego International",434,104,330
2011,3,2011-03,AS,Alaska Airlines Inc.,SAN,"San Diego, CA: San Diego International",338,62,276
2011,3,2011-03,B6,JetBlue Airways,SAN,"San Diego, CA: San Diego International",80,33,47
2011,3,2011-03,CO,Continental Air Lines Inc.,SAN,"San Diego, CA: San Diego International",289,77,212
2011,3,2011-03,DL,Delta Air Lines Inc.,SAN,"San Diego, CA: San Diego International",518,126,392
2011,3,2011-03,F9,Frontier Airlines Inc.,SAN,"San Diego, CA: San Diego International",144,41,103
2011,3,2011-03,HA,Hawaiian Airlines Inc.,SAN,"San Diego, CA: San Diego International",31,7,24
2011,3,2011-03,MQ,American Eagle Airlines Inc.,SAN,"San Diego, CA: San Diego International",364,45,319
2011,3,2011-03,OO,SkyWest Airlines Inc.,SAN,"San Diego, CA: San Diego International",711,159,552
2011,3,2011-03,UA,United Air Lines Inc.,SAN,"San Diego, CA: San Diego International",522,93,429
2011,3,2011-03,US,US Airways Inc.,SAN,"San Diego, CA: San Diego International",292,54,238
2011,3,2011-03,WN,Southwest Airlines Co.,SAN,"San Diego, CA: San Diego International",2804,686,2118
2011,3,2011-03,YV,Mesa Airlines Inc.,SAN,"San Diego, CA: San Diego International",5,1,4
2011,4,2011-04,AA,American Airlines Inc.,SAN,"San Diego, CA: San Diego International",420,166,254
2011,4,2011-04,AS,Alaska Airlines Inc.,SAN,"San Diego, CA: San Diego International",341,36,305
2011,4,2011-04,B6,JetBlue Airways,SAN,"San Diego, CA: San Diego International",81,31,50
2011,4,2011-04,CO,Continental Air Lines Inc.,SAN,"San Diego, CA: San Diego International",271,94,177
2011,4,2011-04,DL,Delta Air Lines Inc.,SAN,"San Diego, CA: San Diego International",501,143,358
2011,4,2011-04,F9,Frontier Airlines Inc.,SAN,"San Diego, CA: San Diego International",120,24,96
2011,4,2011-04,HA,Hawaiian Airlines Inc.,SAN,"San Diego, CA: San Diego International",30,7,23
2011,4,2011-04,MQ,American Eagle Airlines Inc.,SAN,"San Diego, CA: San Diego International",327,41,286
2011,4,2011-04,OO,SkyWest Airlines Inc.,SAN,"San Diego, CA: San Diego International",615,84,531
2011,4,2011-04,UA,United Air Lines Inc.,SAN,"San Diego, CA: San Diego International",479,104,375
2011,4,2011-04,US,US Airways Inc.,SAN,"San Diego, CA: San Diego International",284,64,220
2011,4,2011-04,WN,Southwest Airlines Co.,SAN,"San Diego, CA: San Diego International",2705,665,2040
2011,4,2011-04,YV,Mesa Airlines Inc.,SAN,"San Diego, CA: San Diego International",26,1,25
2011,5,2011-05,AA,American Airlines Inc.,SAN,"San Diego, CA: San Diego International",417,137,280
2011,5,2011-05,AS,Alaska Airlines Inc.,SAN,"San Diego, CA: San Diego International",359,25,334
2011,5,2011-05,B6,JetBlue Airways,SAN,"San Diego, CA: San Diego International",89,12,77
2011,5,2011-05,CO,Continental Air Lines Inc.,SAN,"San Diego, CA: San Diego International",274,67,207
2011,5,2011-05,DL,Delta Air Lines Inc.,SAN,"San Diego, CA: San Diego International",557,94,463
2011,5,2011-05,F9,Frontier Airlines Inc.,SAN,"San Diego, CA: San Diego International",138,43,95
2011,5,2011-05,HA,Hawaiian Airlines Inc.,SAN,"San Diego, CA: San Diego International",31,14,17
2011,5,2011-05,MQ,American Eagle Airlines Inc.,SAN,"San Diego, CA: San Diego International",337,36,301
2011,5,2011-05,OO,SkyWest Airlines Inc.,SAN,"San Diego, CA: San Diego International",617,87,530
2011,5,2011-05,UA,United Air Lines Inc.,SAN,"San Diego, CA: San Diego International",485,93,392
2011,5,2011-05,US,US Airways Inc.,SAN,"San Diego, CA: San Diego International",348,70,278
2011,5,2011-05,WN,Southwest Airlines Co.,SAN,"San Diego, CA: San Diego International",2835,587,2248
2011,5,2011-05,YV,Mesa Airlines Inc.,SAN,"San Diego, CA: San Diego International",31,0,31
2011,6,2011-06,AA,American Airlines Inc.,SAN,"San Diego, CA: San Diego International",438,129,309
2011,6,2011-06,AS,Alaska Airlines Inc.,SAN,"San Diego, CA: San Diego International",348,30,318
2011,6,2011-06,B6,JetBlue Airways,SAN,"San Diego, CA: San Diego International",103,29,74
2011,6,2011-06,CO,Continental Air Lines Inc.,SAN,"San Diego, CA: San Diego International",322,89,233
2011,6,2011-06,DL,Delta Air Lines Inc.,SAN,"San Diego, CA: San Diego International",602,125,477
2011,6,2011-06,F9,Frontier Airlines Inc.,SAN,"San Diego, CA: San Diego International",142,29,113
2011,6,2011-06,HA,Hawaiian Airlines Inc.,SAN,"San Diego, CA: San Diego International",30,5,25
2011,6,2011-06,MQ,American Eagle Airlines Inc.,SAN,"San Diego, CA: San Diego International",326,42,284
2011,6,2011-06,OO,SkyWest Airlines Inc.,SAN,"San Diego, CA: San Diego International",634,124,510
2011,6,2011-06,UA,United Air Lines Inc.,SAN,"San Diego, CA: San Diego International",497,139,358
2011,6,2011-06,US,US Airways Inc.,SAN,"San Diego, CA: San Diego International",344,73,271
2011,6,2011-06,WN,Southwest Airlines Co.,SAN,"San Diego, CA: San Diego International",2811,578,2233
2011,6,2011-06,YV,Mesa Airlines Inc.,SAN,"San Diego, CA: San Diego International",26,6,20
2011,7,2011-07,AA,American Airlines Inc.,SAN,"San Diego, CA: San Diego International",462,95,367
2011,7,2011-07,AS,Alaska Airlines Inc.,SAN,"San Diego, CA: San Diego International",355,43,312
2011,7,2011-07,B6,JetBlue Airways,SAN,"San Diego, CA: San Diego International",122,18,104
2011,7,2011-07,CO,Continental Air Lines Inc.,SAN,"San Diego, CA: San Diego International",349,53,296
2011,7,2011-07,DL,Delta Air Lines Inc.,SAN,"San Diego, CA: San Diego International",632,79,553
2011,7,2011-07,F9,Frontier Airlines Inc.,SAN,"San Diego, CA: San Diego International",169,35,134
2011,7,2011-07,HA,Hawaiian Airlines Inc.,SAN,"San Diego, CA: San Diego International",31,7,24
2011,7,2011-07,MQ,American Eagle Airlines Inc.,SAN,"San Diego, CA: San Diego International",336,21,315
2011,7,2011-07,OO,SkyWest Airlines Inc.,SAN,"San Diego, CA: San Diego International",659,127,532
2011,7,2011-07,UA,United Air Lines Inc.,SAN,"San Diego, CA: San Diego International",513,132,381
2011,7,2011-07,US,US Airways Inc.,SAN,"San Diego, CA: San Diego International",356,51,305
2011,7,2011-07,WN,Southwest Airlines Co.,SAN,"San Diego, CA: San Diego International",2855,423,2432
2011,7,2011-07,YV,Mesa Airlines Inc.,SAN,"San Diego, CA: San Diego International",26,4,22
2011,8,2011-08,AA,American Airlines Inc.,SAN,"San Diego, CA: San Diego International",462,95,367
2011,8,2011-08,AS,Alaska Airlines Inc.,SAN,"San Diego, CA: San Diego International",357,24,333
2011,8,2011-08,B6,JetBlue Airways,SAN,"San Diego, CA: San Diego International",124,29,95
2011,8,2011-08,CO,Continental Air Lines Inc.,SAN,"San Diego, CA: San Diego International",323,68,255
2011,8,2011-08,DL,Delta Air Lines Inc.,SAN,"San Diego, CA: San Diego International",596,82,514
2011,8,2011-08,F9,Frontier Airlines Inc.,SAN,"San Diego, CA: San Diego International",167,24,143
2011,8,2011-08,HA,Hawaiian Airlines Inc.,SAN,"San Diego, CA: San Diego International",31,4,27
2011,8,2011-08,MQ,American Eagle Airlines Inc.,SAN,"San Diego, CA: San Diego International",319,27,292
2011,8,2011-08,OO,SkyWest Airlines Inc.,SAN,"San Diego, CA: San Diego International",655,117,538
2011,8,2011-08,UA,United Air Lines Inc.,SAN,"San Diego, CA: San Diego International",523,113,410
2011,8,2011-08,US,US Airways Inc.,SAN,"San Diego, CA: San Diego International",344,56,288
2011,8,2011-08,WN,Southwest Airlines Co.,SAN,"San Diego, CA: San Diego International",2851,399,2452
2011,8,2011-08,YV,Mesa Airlines Inc.,SAN,"San Diego, CA: San Diego International",27,0,27
2011,9,2011-09,AA,American Airlines Inc.,SAN,"San Diego, CA: San Diego International",439,72,367
2011,9,2011-09,AS,Alaska Airlines Inc.,SAN,"San Diego, CA: San Diego International",326,24,302
2011,9,2011-09,B6,JetBlue Airways,SAN,"San Diego, CA: San Diego International",113,13,100
2011,9,2011-09,CO,Continental Air Lines Inc.,SAN,"San Diego, CA: San Diego International",243,22,221
2011,9,2011-09,DL,Delta Air Lines Inc.,SAN,"San Diego, CA: San Diego International",529,40,489
2011,9,2011-09,F9,Frontier Airlines Inc.,SAN,"San Diego, CA: San Diego International",132,12,120
2011,9,2011-09,HA,Hawaiian Airlines Inc.,SAN,"San Diego, CA: San Diego International",30,3,27
2011,9,2011-09,MQ,American Eagle Airlines Inc.,SAN,"San Diego, CA: San Diego International",266,12,254
2011,9,2011-09,OO,SkyWest Airlines Inc.,SAN,"San Diego, CA: San Diego International",561,114,447
2011,9,2011-09,UA,United Air Lines Inc.,SAN,"San Diego, CA: San Diego International",530,65,465
2011,9,2011-09,US,US Airways Inc.,SAN,"San Diego, CA: San Diego International",291,41,250
2011,9,2011-09,WN,Southwest Airlines Co.,SAN,"San Diego, CA: San Diego International",2679,350,2329
2011,9,2011-09,YV,Mesa Airlines Inc.,SAN,"San Diego, CA: San Diego International",28,2,26
2011,10,2011-10,AA,American Airlines Inc.,SAN,"San Diego, CA: San Diego International",431,120,311
2011,10,2011-10,AS,Alaska Airlines Inc.,SAN,"San Diego, CA: San Diego International",336,31,305
2011,10,2011-10,B6,JetBlue Airways,SAN,"San Diego, CA: San Diego International",113,24,89
2011,10,2011-10,CO,Continental Air Lines Inc.,SAN,"San Diego, CA: San Diego International",251,50,201
2011,10,2011-10,DL,Delta Air Lines Inc.,SAN,"San Diego, CA: San Diego International",548,37,511
2011,10,2011-10,F9,Frontier Airlines Inc.,SAN,"San Diego, CA: San Diego International",142,19,123
2011,10,2011-10,HA,Hawaiian Airlines Inc.,SAN,"San Diego, CA: San Diego International",31,9,22
2011,10,2011-10,MQ,American Eagle Airlines Inc.,SAN,"San Diego, CA: San Diego International",274,19,255
2011,10,2011-10,OO,SkyWest Airlines Inc.,SAN,"San Diego, CA: San Diego International",587,122,465
2011,10,2011-10,UA,United Air Lines Inc.,SAN,"San Diego, CA: San Diego International",534,86,448
2011,10,2011-10,US,US Airways Inc.,SAN,"San Diego, CA: San Diego International",306,40,266
2011,10,2011-10,WN,Southwest Airlines Co.,SAN,"San Diego, CA: San Diego International",2740,351,2389
2011,10,2011-10,YV,Mesa Airlines Inc.,SAN,"San Diego, CA: San Diego International",31,3,28
2011,11,2011-11,AA,American Airlines Inc.,SAN,"San Diego, CA: San Diego International",402,110,292
2011,11,2011-11,AS,Alaska Airlines Inc.,SAN,"San Diego, CA: San Diego International",331,35,296
2011,11,2011-11,B6,JetBlue Airways,SAN,"San Diego, CA: San Diego International",98,19,79
2011,11,2011-11,CO,Continental Air Lines Inc.,SAN,"San Diego, CA: San Diego International",243,53,190
2011,11,2011-11,DL,Delta Air Lines Inc.,SAN,"San Diego, CA: San Diego International",496,76,420
2011,11,2011-11,F9,Frontier Airlines Inc.,SAN,"San Diego, CA: San Diego International",114,18,96
2011,11,2011-11,HA,Hawaiian Airlines Inc.,SAN,"San Diego, CA: San Diego International",30,4,26
2011,11,2011-11,MQ,American Eagle Airlines Inc.,SAN,"San Diego, CA: San Diego International",284,30,254
2011,11,2011-11,OO,SkyWest Airlines Inc.,SAN,"San Diego, CA: San Diego International",562,124,438
2011,11,2011-11,UA,United Air Lines Inc.,SAN,"San Diego, CA: San Diego International",505,96,409
2011,11,2011-11,US,US Airways Inc.,SAN,"San Diego, CA: San Diego International",297,42,255
2011,11,2011-11,WN,Southwest Airlines Co.,SAN,"San Diego, CA: San Diego International",2588,306,2282
2011,11,2011-11,YV,Mesa Airlines Inc.,SAN,"San Diego, CA: San Diego International",30,6,24
2011,12,2011-12,AA,American Airlines Inc.,SAN,"San Diego, CA: San Diego International",391,75,316
2011,12,2011-12,AS,Alaska Airlines Inc.,SAN,"San Diego, CA: San Diego International",357,34,323
2011,12,2011-12,B6,JetBlue Airways,SAN,"San Diego, CA: San Diego International",98,6,92
2011,12,2011-12,CO,Continental Air Lines Inc.,SAN,"San Diego, CA: San Diego International",324,68,256
2011,12,2011-12,DL,Delta Air Lines Inc.,SAN,"San Diego, CA: San Diego International",493,48,445
2011,12,2011-12,F9,Frontier Airlines Inc.,SAN,"San Diego, CA: San Diego International",108,25,83
2011,12,2011-12,HA,Hawaiian Airlines Inc.,SAN,"San Diego, CA: San Diego International",31,6,25
2011,12,2011-12,MQ,American Eagle Airlines Inc.,SAN,"San Diego, CA: San Diego International",319,20,299
2011,12,2011-12,OO,SkyWest Airlines Inc.,SAN,"San Diego, CA: San Diego International",656,119,537
2011,12,2011-12,UA,United Air Lines Inc.,SAN,"San Diego, CA: San Diego International",511,62,449
2011,12,2011-12,US,US Airways Inc.,SAN,"San Diego, CA: San Diego International",341,31,310
2011,12,2011-12,WN,Southwest Airlines Co.,SAN,"San Diego, CA: San Diego International",2658,319,2339
2011,12,2011-12,YV,Mesa Airlines Inc.,SAN,"San Diego, CA: San Diego International",29,6,23
2012,1,2012-01,AA,American Airlines Inc.,SAN,"San Diego, CA: San Diego International",374,58,316
2012,1,2012-01,AS,Alaska Airlines Inc.,SAN,"San Diego, CA: San Diego International",358,62,296
2012,1,2012-01,B6,JetBlue Airways,SAN,"San Diego, CA: San Diego International",82,7,75
2012,1,2012-01,DL,Delta Air Lines Inc.,SAN,"San Diego, CA: San Diego International",462,51,411
2012,1,2012-01,F9,Frontier Airlines Inc.,SAN,"San Diego, CA: San Diego International",109,23,86
2012,1,2012-01,HA,Hawaiian Airlines Inc.,SAN,"San Diego, CA: San Diego International",31,7,24
2012,1,2012-01,MQ,American Eagle Airlines Inc.,SAN,"San Diego, CA: San Diego International",313,18,295
2012,1,2012-01,OO,SkyWest Airlines Inc.,SAN,"San Diego, CA: San Diego International",614,109,505
2012,1,2012-01,UA,United Air Lines Inc.,SAN,"San Diego, CA: San Diego International",767,112,655
2012,1,2012-01,US,US Airways Inc.,SAN,"San Diego, CA: San Diego International",290,30,260
2012,1,2012-01,VX,Virgin America,SAN,"San Diego, CA: San Diego International",111,13,98
2012,1,2012-01,WN,Southwest Airlines Co.,SAN,"San Diego, CA: San Diego International",2577,313,2264
2012,1,2012-01,YV,Mesa Airlines Inc.,SAN,"San Diego, CA: San Diego International",31,1,30
2012,2,2012-02,AA,American Airlines Inc.,SAN,"San Diego, CA: San Diego International",384,74,310
2012,2,2012-02,AS,Alaska Airlines Inc.,SAN,"San Diego, CA: San Diego International",336,31,305
2012,2,2012-02,B6,JetBlue Airways,SAN,"San Diego, CA: San Diego International",78,13,65
2012,2,2012-02,DL,Delta Air Lines Inc.,SAN,"San Diego, CA: San Diego International",431,51,380
2012,2,2012-02,F9,Frontier Airlines Inc.,SAN,"San Diego, CA: San Diego International",104,42,62
2012,2,2012-02,HA,Hawaiian Airlines Inc.,SAN,"San Diego, CA: San Diego International",29,9,20
2012,2,2012-02,MQ,American Eagle Airlines Inc.,SAN,"San Diego, CA: San Diego International",293,25,268
2012,2,2012-02,OO,SkyWest Airlines Inc.,SAN,"San Diego, CA: San Diego International",573,71,502
2012,2,2012-02,UA,United Air Lines Inc.,SAN,"San Diego, CA: San Diego International",730,124,606
2012,2,2012-02,US,US Airways Inc.,SAN,"San Diego, CA: San Diego International",276,28,248
2012,2,2012-02,VX,Virgin America,SAN,"San Diego, CA: San Diego International",107,6,101
2012,2,2012-02,WN,Southwest Airlines Co.,SAN,"San Diego, CA: San Diego International",2508,234,2274
2012,2,2012-02,YV,Mesa Airlines Inc.,SAN,"San Diego, CA: San Diego International",29,1,28
2012,3,2012-03,AA,American Airlines Inc.,SAN,"San Diego, CA: San Diego International",429,84,345
2012,3,2012-03,AS,Alaska Airlines Inc.,SAN,"San Diego, CA: San Diego International",373,59,314
2012,3,2012-03,B6,JetBlue Airways,SAN,"San Diego, CA: San Diego International",88,9,79
2012,3,2012-03,DL,Delta Air Lines Inc.,SAN,"San Diego, CA: San Diego International",498,66,432
2012,3,2012-03,F9,Frontier Airlines Inc.,SAN,"San Diego, CA: San Diego International",120,18,102
2012,3,2012-03,HA,Hawaiian Airlines Inc.,SAN,"San Diego, CA: San Diego International",31,11,20
2012,3,2012-03,MQ,American Eagle Airlines Inc.,SAN,"San Diego, CA: San Diego International",315,29,286
2012,3,2012-03,OO,SkyWest Airlines Inc.,SAN,"San Diego, CA: San Diego International",652,150,502
2012,3,2012-03,UA,United Air Lines Inc.,SAN,"San Diego, CA: San Diego International",806,130,676
2012,3,2012-03,US,US Airways Inc.,SAN,"San Diego, CA: San Diego International",325,46,279
2012,3,2012-03,VX,Virgin America,SAN,"San Diego, CA: San Diego International",119,24,95
2012,3,2012-03,WN,Southwest Airlines Co.,SAN,"San Diego, CA: San Diego International",2768,355,2413
2012,3,2012-03,YV,Mesa Airlines Inc.,SAN,"San Diego, CA: San Diego International",3,0,3
2012,4,2012-04,AA,American Airlines Inc.,SAN,"San Diego, CA: San Diego International",416,77,339
2012,4,2012-04,AS,Alaska Airlines Inc.,SAN,"San Diego, CA: San Diego International",368,39,329
2012,4,2012-04,B6,JetBlue Airways,SAN,"San Diego, CA: San Diego International",86,8,78
2012,4,2012-04,DL,Delta Air Lines Inc.,SAN,"San Diego, CA: San Diego International",481,32,449
2012,4,2012-04,F9,Frontier Airlines Inc.,SAN,"San Diego, CA: San Diego International",98,8,90
2012,4,2012-04,HA,Hawaiian Airlines Inc.,SAN,"San Diego, CA: San Diego International",30,11,19
2012,4,2012-04,MQ,American Eagle Airlines Inc.,SAN,"San Diego, CA: San Diego International",298,34,264
2012,4,2012-04,OO,SkyWest Airlines Inc.,SAN,"San Diego, CA: San Diego International",655,119,536
2012,4,2012-04,UA,United Air Lines Inc.,SAN,"San Diego, CA: San Diego International",760,147,613
2012,4,2012-04,US,US Airways Inc.,SAN,"San Diego, CA: San Diego International",305,26,279
2012,4,2012-04,VX,Virgin America,SAN,"San Diego, CA: San Diego International",116,14,102
2012,4,2012-04,WN,Southwest Airlines Co.,SAN,"San Diego, CA: San Diego International",2716,348,2368
2012,5,2012-05,AA,American Airlines Inc.,SAN,"San Diego, CA: San Diego International",428,89,339
2012,5,2012-05,AS,Alaska Airlines Inc.,SAN,"San Diego, CA: San Diego International",379,21,358
2012,5,2012-05,B6,JetBlue Airways,SAN,"San Diego, CA: San Diego International",88,7,81
2012,5,2012-05,DL,Delta Air Lines Inc.,SAN,"San Diego, CA: San Diego International",513,39,474
2012,5,2012-05,F9,Frontier Airlines Inc.,SAN,"San Diego, CA: San Diego International",111,19,92
2012,5,2012-05,HA,Hawaiian Airlines Inc.,SAN,"San Diego, CA: San Diego International",31,12,19
2012,5,2012-05,MQ,American Eagle Airlines Inc.,SAN,"San Diego, CA: San Diego International",304,30,274
2012,5,2012-05,OO,SkyWest Airlines Inc.,SAN,"San Diego, CA: San Diego International",669,104,565
2012,5,2012-05,UA,United Air Lines Inc.,SAN,"San Diego, CA: San Diego International",786,133,653
2012,5,2012-05,US,US Airways Inc.,SAN,"San Diego, CA: San Diego International",338,39,299
2012,5,2012-05,VX,Virgin America,SAN,"San Diego, CA: San Diego International",147,14,133
2012,5,2012-05,WN,Southwest Airlines Co.,SAN,"San Diego, CA: San Diego International",2781,325,2456
2012,6,2012-06,AA,American Airlines Inc.,SAN,"San Diego, CA: San Diego International",401,76,325
2012,6,2012-06,AS,Alaska Airlines Inc.,SAN,"San Diego, CA: San Diego International",416,38,378
2012,6,2012-06,B6,JetBlue Airways,SAN,"San Diego, CA: San Diego International",87,15,72
2012,6,2012-06,DL,Delta Air Lines Inc.,SAN,"San Diego, CA: San Diego International",590,63,527
2012,6,2012-06,F9,Frontier Airlines Inc.,SAN,"San Diego, CA: San Diego International",119,27,92
2012,6,2012-06,HA,Hawaiian Airlines Inc.,SAN,"San Diego, CA: San Diego International",30,14,16
2012,6,2012-06,MQ,American Eagle Airlines Inc.,SAN,"San Diego, CA: San Diego International",295,25,270
2012,6,2012-06,OO,SkyWest Airlines Inc.,SAN,"San Diego, CA: San Diego International",688,121,567
2012,6,2012-06,UA,United Air Lines Inc.,SAN,"San Diego, CA: San Diego International",844,214,630
2012,6,2012-06,US,US Airways Inc.,SAN,"San Diego, CA: San Diego International",371,51,320
2012,6,2012-06,VX,Virgin America,SAN,"San Diego, CA: San Diego International",145,28,117
2012,6,2012-06,WN,Southwest Airlines Co.,SAN,"San Diego, CA: San Diego International",2786,525,2261
2012,7,2012-07,AA,American Airlines Inc.,SAN,"San Diego, CA: San Diego International",421,98,323
2012,7,2012-07,AS,Alaska Airlines Inc.,SAN,"San Diego, CA: San Diego International",433,44,389
2012,7,2012-07,B6,JetBlue Airways,SAN,"San Diego, CA: San Diego International",109,17,92
2012,7,2012-07,DL,Delta Air Lines Inc.,SAN,"San Diego, CA: San Diego International",616,83,533
2012,7,2012-07,F9,Frontier Airlines Inc.,SAN,"San Diego, CA: San Diego International",124,23,101
2012,7,2012-07,HA,Hawaiian Airlines Inc.,SAN,"San Diego, CA: San Diego International",31,7,24
2012,7,2012-07,MQ,American Eagle Airlines Inc.,SAN,"San Diego, CA: San Diego International",299,27,272
2012,7,2012-07,OO,SkyWest Airlines Inc.,SAN,"San Diego, CA: San Diego International",719,119,600
2012,7,2012-07,UA,United Air Lines Inc.,SAN,"San Diego, CA: San Diego International",887,314,573
2012,7,2012-07,US,US Airways Inc.,SAN,"San Diego, CA: San Diego International",392,66,326
2012,7,2012-07,VX,Virgin America,SAN,"San Diego, CA: San Diego International",151,27,124
2012,7,2012-07,WN,Southwest Airlines Co.,SAN,"San Diego, CA: San Diego International",2853,532,2321
2012,8,2012-08,AA,American Airlines Inc.,SAN,"San Diego, CA: San Diego International",430,107,323
2012,8,2012-08,AS,Alaska Airlines Inc.,SAN,"San Diego, CA: San Diego International",427,30,397
2012,8,2012-08,B6,JetBlue Airways,SAN,"San Diego, CA: San Diego International",124,21,103
2012,8,2012-08,DL,Delta Air Lines Inc.,SAN,"San Diego, CA: San Diego International",572,58,514
2012,8,2012-08,F9,Frontier Airlines Inc.,SAN,"San Diego, CA: San Diego International",117,24,93
2012,8,2012-08,HA,Hawaiian Airlines Inc.,SAN,"San Diego, CA: San Diego International",31,6,25
2012,8,2012-08,MQ,American Eagle Airlines Inc.,SAN,"San Diego, CA: San Diego International",306,32,274
2012,8,2012-08,OO,SkyWest Airlines Inc.,SAN,"San Diego, CA: San Diego International",718,153,565
2012,8,2012-08,UA,United Air Lines Inc.,SAN,"San Diego, CA: San Diego International",851,227,624
2012,8,2012-08,US,US Airways Inc.,SAN,"San Diego, CA: San Diego International",377,63,314
2012,8,2012-08,VX,Virgin America,SAN,"San Diego, CA: San Diego International",149,18,131
2012,8,2012-08,WN,Southwest Airlines Co.,SAN,"San Diego, CA: San Diego International",2765,538,2227
2012,9,2012-09,AA,American Airlines Inc.,SAN,"San Diego, CA: San Diego International",404,195,209
2012,9,2012-09,AS,Alaska Airlines Inc.,SAN,"San Diego, CA: San Diego International",358,20,338
2012,9,2012-09,B6,JetBlue Airways,SAN,"San Diego, CA: San Diego International",110,20,90
2012,9,2012-09,DL,Delta Air Lines Inc.,SAN,"San Diego, CA: San Diego International",472,37,435
2012,9,2012-09,F9,Frontier Airlines Inc.,SAN,"San Diego, CA: San Diego International",118,21,97
2012,9,2012-09,HA,Hawaiian Airlines Inc.,SAN,"San Diego, CA: San Diego International",30,4,26
2012,9,2012-09,MQ,American Eagle Airlines Inc.,SAN,"San Diego, CA: San Diego International",291,34,257
2012,9,2012-09,OO,SkyWest Airlines Inc.,SAN,"San Diego, CA: San Diego International",629,102,527
2012,9,2012-09,UA,United Air Lines Inc.,SAN,"San Diego, CA: San Diego International",772,121,651
2012,9,2012-09,US,US Airways Inc.,SAN,"San Diego, CA: San Diego International",318,43,275
2012,9,2012-09,VX,Virgin America,SAN,"San Diego, CA: San Diego International",141,12,129
2012,9,2012-09,WN,Southwest Airlines Co.,SAN,"San Diego, CA: San Diego International",2542,365,2177
2012,10,2012-10,AA,American Airlines Inc.,SAN,"San Diego, CA: San Diego International",394,176,218
2012,10,2012-10,AS,Alaska Airlines Inc.,SAN,"San Diego, CA: San Diego International",383,34,349
2012,10,2012-10,B6,JetBlue Airways,SAN,"San Diego, CA: San Diego International",106,29,77
2012,10,2012-10,DL,Delta Air Lines Inc.,SAN,"San Diego, CA: San Diego International",493,57,436
2012,10,2012-10,F9,Frontier Airlines Inc.,SAN,"San Diego, CA: San Diego International",129,33,96
2012,10,2012-10,HA,Hawaiian Airlines Inc.,SAN,"San Diego, CA: San Diego International",31,3,28
2012,10,2012-10,MQ,American Eagle Airlines Inc.,SAN,"San Diego, CA: San Diego International",306,40,266
2012,10,2012-10,OO,SkyWest Airlines Inc.,SAN,"San Diego, CA: San Diego International",653,148,505
2012,10,2012-10,UA,United Air Lines Inc.,SAN,"San Diego, CA: San Diego International",783,173,610
2012,10,2012-10,US,US Airways Inc.,SAN,"San Diego, CA: San Diego International",339,49,290
2012,10,2012-10,VX,Virgin America,SAN,"San Diego, CA: San Diego International",142,19,123
2012,10,2012-10,WN,Southwest Airlines Co.,SAN,"San Diego, CA: San Diego International",2668,455,2213
2012,11,2012-11,AA,American Airlines Inc.,SAN,"San Diego, CA: San Diego International",386,102,284
2012,11,2012-11,AS,Alaska Airlines Inc.,SAN,"San Diego, CA: San Diego International",362,35,327
2012,11,2012-11,B6,JetBlue Airways,SAN,"San Diego, CA: San Diego International",95,9,86
2012,11,2012-11,DL,Delta Air Lines Inc.,SAN,"San Diego, CA: San Diego International",461,48,413
2012,11,2012-11,F9,Frontier Airlines Inc.,SAN,"San Diego, CA: San Diego International",134,31,103
2012,11,2012-11,HA,Hawaiian Airlines Inc.,SAN,"San Diego, CA: San Diego International",30,3,27
2012,11,2012-11,MQ,American Eagle Airlines Inc.,SAN,"San Diego, CA: San Diego International",169,27,142
2012,11,2012-11,OO,SkyWest Airlines Inc.,SAN,"San Diego, CA: San Diego International",761,123,638
2012,11,2012-11,UA,United Air Lines Inc.,SAN,"San Diego, CA: San Diego International",707,94,613
2012,11,2012-11,US,US Airways Inc.,SAN,"San Diego, CA: San Diego International",328,31,297
2012,11,2012-11,VX,Virgin America,SAN,"San Diego, CA: San Diego International",143,15,128
2012,11,2012-11,WN,Southwest Airlines Co.,SAN,"San Diego, CA: San Diego International",2510,375,2135
2012,11,2012-11,YV,Mesa Airlines Inc.,SAN,"San Diego, CA: San Diego International",1,0,1
2012,12,2012-12,AA,American Airlines Inc.,SAN,"San Diego, CA: San Diego International",414,127,287
2012,12,2012-12,AS,Alaska Airlines Inc.,SAN,"San Diego, CA: San Diego International",368,49,319
2012,12,2012-12,B6,JetBlue Airways,SAN,"San Diego, CA: San Diego International",96,38,58
2012,12,2012-12,DL,Delta Air Lines Inc.,SAN,"San Diego, CA: San Diego International",477,70,407
2012,12,2012-12,F9,Frontier Airlines Inc.,SAN,"San Diego, CA: San Diego International",130,61,69
2012,12,2012-12,HA,Hawaiian Airlines Inc.,SAN,"San Diego, CA: San Diego International",31,7,24
2012,12,2012-12,MQ,American Eagle Airlines Inc.,SAN,"San Diego, CA: San Diego International",62,18,44
2012,12,2012-12,OO,SkyWest Airlines Inc.,SAN,"San Diego, CA: San Diego International",941,201,740
2012,12,2012-12,UA,United Air Lines Inc.,SAN,"San Diego, CA: San Diego International",732,187,545
2012,12,2012-12,US,US Airways Inc.,SAN,"San Diego, CA: San Diego International",362,75,287
2012,12,2012-12,VX,Virgin America,SAN,"San Diego, CA: San Diego International",147,24,123
2012,12,2012-12,WN,Southwest Airlines Co.,SAN,"San Diego, CA: San Diego International",2562,739,1823
2012,12,2012-12,YV,Mesa Airlines Inc.,SAN,"San Diego, CA: San Diego International",2,0,2
2013,1,2013-01,AA,American Airlines Inc.,SAN,"San Diego, CA: San Diego International",397,69,328
2013,1,2013-01,AS,Alaska Airlines Inc.,SAN,"San Diego, CA: San Diego International",376,38,338
2013,1,2013-01,B6,JetBlue Airways,SAN,"San Diego, CA: San Diego International",87,21,66
2013,1,2013-01,DL,Delta Air Lines Inc.,SAN,"San Diego, CA: San Diego International",447,54,393
2013,1,2013-01,F9,Frontier Airlines Inc.,SAN,"San Diego, CA: San Diego International",126,37,89
2013,1,2013-01,HA,Hawaiian Airlines Inc.,SAN,"San Diego, CA: San Diego International",31,5,26
2013,1,2013-01,MQ,American Eagle Airlines Inc.,SAN,"San Diego, CA: San Diego International",62,15,47
2013,1,2013-01,OO,SkyWest Airlines Inc.,SAN,"San Diego, CA: San Diego International",930,131,799
2013,1,2013-01,UA,United Air Lines Inc.,SAN,"San Diego, CA: San Diego International",701,113,588
2013,1,2013-01,US,US Airways Inc.,SAN,"San Diego, CA: San Diego International",335,71,264
2013,1,2013-01,VX,Virgin America,SAN,"San Diego, CA: San Diego International",128,5,123
2013,1,2013-01,WN,Southwest Airlines Co.,SAN,"San Diego, CA: San Diego International",2499,327,2172
2013,1,2013-01,YV,Mesa Airlines Inc.,SAN,"San Diego, CA: San Diego International",1,0,1
2013,2,2013-02,AA,American Airlines Inc.,SAN,"San Diego, CA: San Diego International",367,90,277
2013,2,2013-02,AS,Alaska Airlines Inc.,SAN,"San Diego, CA: San Diego International",340,16,324
2013,2,2013-02,B6,JetBlue Airways,SAN,"San Diego, CA: San Diego International",72,21,51
2013,2,2013-02,DL,Delta Air Lines Inc.,SAN,"San Diego, CA: San Diego International",403,39,364
2013,2,2013-02,F9,Frontier Airlines Inc.,SAN,"San Diego, CA: San Diego International",115,32,83
2013,2,2013-02,HA,Hawaiian Airlines Inc.,SAN,"San Diego, CA: San Diego International",28,4,24
2013,2,2013-02,MQ,American Eagle Airlines Inc.,SAN,"San Diego, CA: San Diego International",56,12,44
2013,2,2013-02,OO,SkyWest Airlines Inc.,SAN,"San Diego, CA: San Diego International",840,111,729
2013,2,2013-02,UA,United Air Lines Inc.,SAN,"San Diego, CA: San Diego International",656,124,532
2013,2,2013-02,US,US Airways Inc.,SAN,"San Diego, CA: San Diego International",305,54,251
2013,2,2013-02,VX,Virgin America,SAN,"San Diego, CA: San Diego International",113,16,97
2013,2,2013-02,WN,Southwest Airlines Co.,SAN,"San Diego, CA: San Diego International",2314,257,2057
2013,3,2013-03,AA,American Airlines Inc.,SAN,"San Diego, CA: San Diego International",421,81,340
2013,3,2013-03,AS,Alaska Airlines Inc.,SAN,"San Diego, CA: San Diego International",405,44,361
2013,3,2013-03,B6,JetBlue Airways,SAN,"San Diego, CA: San Diego International",81,18,63
2013,3,2013-03,DL,Delta Air Lines Inc.,SAN,"San Diego, CA: San Diego International",520,71,449
2013,3,2013-03,F9,Frontier Airlines Inc.,SAN,"San Diego, CA: San Diego International",106,30,76
2013,3,2013-03,HA,Hawaiian Airlines Inc.,SAN,"San Diego, CA: San Diego International",31,5,26
2013,3,2013-03,MQ,American Eagle Airlines Inc.,SAN,"San Diego, CA: San Diego International",62,20,42
2013,3,2013-03,OO,SkyWest Airlines Inc.,SAN,"San Diego, CA: San Diego International",937,158,779
2013,3,2013-03,UA,United Air Lines Inc.,SAN,"San Diego, CA: San Diego International",736,123,613
2013,3,2013-03,US,US Airways Inc.,SAN,"San Diego, CA: San Diego International",359,57,302
2013,3,2013-03,VX,Virgin America,SAN,"San Diego, CA: San Diego International",134,11,123
2013,3,2013-03,WN,Southwest Airlines Co.,SAN,"San Diego, CA: San Diego International",2704,478,2226
2013,4,2013-04,AA,American Airlines Inc.,SAN,"San Diego, CA: San Diego International",415,136,279
2013,4,2013-04,AS,Alaska Airlines Inc.,SAN,"San Diego, CA: San Diego International",430,36,394
2013,4,2013-04,B6,JetBlue Airways,SAN,"San Diego, CA: San Diego International",86,26,60
2013,4,2013-04,DL,Delta Air Lines Inc.,SAN,"San Diego, CA: San Diego International",496,63,433
2013,4,2013-04,F9,Frontier Airlines Inc.,SAN,"San Diego, CA: San Diego International",96,36,60
2013,4,2013-04,HA,Hawaiian Airlines Inc.,SAN,"San Diego, CA: San Diego International",30,4,26
2013,4,2013-04,MQ,American Eagle Airlines Inc.,SAN,"San Diego, CA: San Diego International",84,22,62
2013,4,2013-04,OO,SkyWest Airlines Inc.,SAN,"San Diego, CA: San Diego International",896,143,753
2013,4,2013-04,UA,United Air Lines Inc.,SAN,"San Diego, CA: San Diego International",675,161,514
2013,4,2013-04,US,US Airways Inc.,SAN,"San Diego, CA: San Diego International",334,80,254
2013,4,2013-04,VX,Virgin America,SAN,"San Diego, CA: San Diego International",144,19,125
2013,4,2013-04,WN,Southwest Airlines Co.,SAN,"San Diego, CA: San Diego International",2707,591,2116
2013,5,2013-05,AA,American Airlines Inc.,SAN,"San Diego, CA: San Diego International",427,105,322
2013,5,2013-05,AS,Alaska Airlines Inc.,SAN,"San Diego, CA: San Diego International",441,25,416
2013,5,2013-05,B6,JetBlue Airways,SAN,"San Diego, CA: San Diego International",115,12,103
2013,5,2013-05,DL,Delta Air Lines Inc.,SAN,"San Diego, CA: San Diego International",519,49,470
2013,5,2013-05,F9,Frontier Airlines Inc.,SAN,"San Diego, CA: San Diego International",110,31,79
2013,5,2013-05,HA,Hawaiian Airlines Inc.,SAN,"San Diego, CA: San Diego International",31,5,26
2013,5,2013-05,MQ,American Eagle Airlines Inc.,SAN,"San Diego, CA: San Diego International",89,25,64
2013,5,2013-05,OO,SkyWest Airlines Inc.,SAN,"San Diego, CA: San Diego International",853,99,754
2013,5,2013-05,UA,United Air Lines Inc.,SAN,"San Diego, CA: San Diego International",733,111,622
2013,5,2013-05,US,US Airways Inc.,SAN,"San Diego, CA: San Diego International",360,70,290
2013,5,2013-05,VX,Virgin America,SAN,"San Diego, CA: San Diego International",146,17,129
2013,5,2013-05,WN,Southwest Airlines Co.,SAN,"San Diego, CA: San Diego International",2788,467,2321
2013,6,2013-06,AA,American Airlines Inc.,SAN,"San Diego, CA: San Diego International",437,163,274
2013,6,2013-06,AS,Alaska Airlines Inc.,SAN,"San Diego, CA: San Diego International",518,59,459
2013,6,2013-06,B6,JetBlue Airways,SAN,"San Diego, CA: San Diego International",115,33,82
2013,6,2013-06,DL,Delta Air Lines Inc.,SAN,"San Diego, CA: San Diego International",579,124,455
2013,6,2013-06,F9,Frontier Airlines Inc.,SAN,"San Diego, CA: San Diego International",120,30,90
2013,6,2013-06,HA,Hawaiian Airlines Inc.,SAN,"San Diego, CA: San Diego International",30,0,30
2013,6,2013-06,MQ,American Eagle Airlines Inc.,SAN,"San Diego, CA: San Diego International",89,31,58
2013,6,2013-06,OO,SkyWest Airlines Inc.,SAN,"San Diego, CA: San Diego International",898,175,723
2013,6,2013-06,UA,United Air Lines Inc.,SAN,"San Diego, CA: San Diego International",737,215,522
2013,6,2013-06,US,US Airways Inc.,SAN,"San Diego, CA: San Diego International",366,126,240
2013,6,2013-06,VX,Virgin America,SAN,"San Diego, CA: San Diego International",140,35,105
2013,6,2013-06,WN,Southwest Airlines Co.,SAN,"San Diego, CA: San Diego International",2734,702,2032
2013,7,2013-07,AA,American Airlines Inc.,SAN,"San Diego, CA: San Diego International",461,120,341
2013,7,2013-07,AS,Alaska Airlines Inc.,SAN,"San Diego, CA: San Diego International",566,132,434
2013,7,2013-07,B6,JetBlue Airways,SAN,"San Diego, CA: San Diego International",123,29,94
2013,7,2013-07,DL,Delta Air Lines Inc.,SAN,"San Diego, CA: San Diego International",621,129,492
2013,7,2013-07,F9,Frontier Airlines Inc.,SAN,"San Diego, CA: San Diego International",102,36,66
2013,7,2013-07,HA,Hawaiian Airlines Inc.,SAN,"San Diego, CA: San Diego International",31,2,29
2013,7,2013-07,MQ,American Eagle Airlines Inc.,SAN,"San Diego, CA: San Diego International",90,17,73
2013,7,2013-07,OO,SkyWest Airlines Inc.,SAN,"San Diego, CA: San Diego International",873,153,720
2013,7,2013-07,UA,United Air Lines Inc.,SAN,"San Diego, CA: San Diego International",807,194,613
2013,7,2013-07,US,US Airways Inc.,SAN,"San Diego, CA: San Diego International",390,78,312
2013,7,2013-07,VX,Virgin America,SAN,"San Diego, CA: San Diego International",143,37,106
2013,7,2013-07,WN,Southwest Airlines Co.,SAN,"San Diego, CA: San Diego International",2808,583,2225
2013,8,2013-08,AA,American Airlines Inc.,SAN,"San Diego, CA: San Diego International",463,96,367
2013,8,2013-08,AS,Alaska Airlines Inc.,SAN,"San Diego, CA: San Diego International",543,82,461
2013,8,2013-08,B6,JetBlue Airways,SAN,"San Diego, CA: San Diego International",124,43,81
2013,8,2013-08,DL,Delta Air Lines Inc.,SAN,"San Diego, CA: San Diego International",584,79,505
2013,8,2013-08,F9,Frontier Airlines Inc.,SAN,"San Diego, CA: San Diego International",120,38,82
2013,8,2013-08,HA,Hawaiian Airlines Inc.,SAN,"San Diego, CA: San Diego International",31,3,28
2013,8,2013-08,MQ,American Eagle Airlines Inc.,SAN,"San Diego, CA: San Diego International",90,12,78
2013,8,2013-08,OO,SkyWest Airlines Inc.,SAN,"San Diego, CA: San Diego International",830,137,693
2013,8,2013-08,UA,United Air Lines Inc.,SAN,"San Diego, CA: San Diego International",824,154,670
2013,8,2013-08,US,US Airways Inc.,SAN,"San Diego, CA: San Diego International",379,75,304
2013,8,2013-08,VX,Virgin America,SAN,"San Diego, CA: San Diego International",144,22,122
2013,8,2013-08,WN,Southwest Airlines Co.,SAN,"San Diego, CA: San Diego International",2718,748,1970
2013,9,2013-09,AA,American Airlines Inc.,SAN,"San Diego, CA: San Diego International",440,73,367
2013,9,2013-09,AS,Alaska Airlines Inc.,SAN,"San Diego, CA: San Diego International",456,55,401
2013,9,2013-09,B6,JetBlue Airways,SAN,"San Diego, CA: San Diego International",111,15,96
2013,9,2013-09,DL,Delta Air Lines Inc.,SAN,"San Diego, CA: San Diego International",473,44,429
2013,9,2013-09,F9,Frontier Airlines Inc.,SAN,"San Diego, CA: San Diego International",120,34,86
2013,9,2013-09,HA,Hawaiian Airlines Inc.,SAN,"San Diego, CA: San Diego International",30,2,28
2013,9,2013-09,MQ,American Eagle Airlines Inc.,SAN,"San Diego, CA: San Diego International",81,3,78
2013,9,2013-09,OO,SkyWest Airlines Inc.,SAN,"San Diego, CA: San Diego International",699,103,596
2013,9,2013-09,UA,United Air Lines Inc.,SAN,"San Diego, CA: San Diego International",760,99,661
2013,9,2013-09,US,US Airways Inc.,SAN,"San Diego, CA: San Diego International",310,25,285
2013,9,2013-09,VX,Virgin America,SAN,"San Diego, CA: San Diego International",132,13,119
2013,9,2013-09,WN,Southwest Airlines Co.,SAN,"San Diego, CA: San Diego International",2554,705,1849
2013,10,2013-10,AA,American Airlines Inc.,SAN,"San Diego, CA: San Diego International",457,148,309
2013,10,2013-10,AS,Alaska Airlines Inc.,SAN,"San Diego, CA: San Diego International",461,41,420
2013,10,2013-10,B6,JetBlue Airways,SAN,"San Diego, CA: San Diego International",117,23,94
2013,10,2013-10,DL,Delta Air Lines Inc.,SAN,"San Diego, CA: San Diego International",496,55,441
2013,10,2013-10,F9,Frontier Airlines Inc.,SAN,"San Diego, CA: San Diego International",122,24,98
2013,10,2013-10,HA,Hawaiian Airlines Inc.,SAN,"San Diego, CA: San Diego International",31,2,29
2013,10,2013-10,MQ,American Eagle Airlines Inc.,SAN,"San Diego, CA: San Diego International",83,13,70
2013,10,2013-10,OO,SkyWest Airlines Inc.,SAN,"San Diego, CA: San Diego International",726,98,628
2013,10,2013-10,UA,United Air Lines Inc.,SAN,"San Diego, CA: San Diego International",782,142,640
2013,10,2013-10,US,US Airways Inc.,SAN,"San Diego, CA: San Diego International",332,60,272
2013,10,2013-10,VX,Virgin America,SAN,"San Diego, CA: San Diego International",143,8,135
2013,10,2013-10,WN,Southwest Airlines Co.,SAN,"San Diego, CA: San Diego International",2633,618,2015
2013,11,2013-11,AA,American Airlines Inc.,SAN,"San Diego, CA: San Diego International",432,129,303
2013,11,2013-11,AS,Alaska Airlines Inc.,SAN,"San Diego, CA: San Diego International",423,43,380
2013,11,2013-11,B6,JetBlue Airways,SAN,"San Diego, CA: San Diego International",107,17,90
2013,11,2013-11,DL,Delta Air Lines Inc.,SAN,"San Diego, CA: San Diego International",457,61,396
2013,11,2013-11,F9,Frontier Airlines Inc.,SAN,"San Diego, CA: San Diego International",116,27,89
2013,11,2013-11,HA,Hawaiian Airlines Inc.,SAN,"San Diego, CA: San Diego International",30,2,28
2013,11,2013-11,MQ,American Eagle Airlines Inc.,SAN,"San Diego, CA: San Diego International",92,13,79
2013,11,2013-11,OO,SkyWest Airlines Inc.,SAN,"San Diego, CA: San Diego International",717,95,622
2013,11,2013-11,UA,United Air Lines Inc.,SAN,"San Diego, CA: San Diego International",725,110,615
2013,11,2013-11,US,US Airways Inc.,SAN,"San Diego, CA: San Diego International",302,38,264
2013,11,2013-11,VX,Virgin America,SAN,"San Diego, CA: San Diego International",139,16,123
2013,11,2013-11,WN,Southwest Airlines Co.,SAN,"San Diego, CA: San Diego International",2489,472,2017
2013,12,2013-12,AA,American Airlines Inc.,SAN,"San Diego, CA: San Diego International",448,140,308
2013,12,2013-12,AS,Alaska Airlines Inc.,SAN,"San Diego, CA: San Diego International",434,47,387
2013,12,2013-12,B6,JetBlue Airways,SAN,"San Diego, CA: San Diego International",110,52,58
2013,12,2013-12,DL,Delta Air Lines Inc.,SAN,"San Diego, CA: San Diego International",450,91,359
2013,12,2013-12,F9,Frontier Airlines Inc.,SAN,"San Diego, CA: San Diego International",115,39,76
2013,12,2013-12,HA,Hawaiian Airlines Inc.,SAN,"San Diego, CA: San Diego International",31,7,24
2013,12,2013-12,MQ,American Eagle Airlines Inc.,SAN,"San Diego, CA: San Diego International",115,39,76
2013,12,2013-12,OO,SkyWest Airlines Inc.,SAN,"San Diego, CA: San Diego International",741,145,596
2013,12,2013-12,UA,United Air Lines Inc.,SAN,"San Diego, CA: San Diego International",715,163,552
2013,12,2013-12,US,US Airways Inc.,SAN,"San Diego, CA: San Diego International",315,54,261
2013,12,2013-12,VX,Virgin America,SAN,"San Diego, CA: San Diego International",145,8,137
2013,12,2013-12,WN,Southwest Airlines Co.,SAN,"San Diego, CA: San Diego International",2624,966,1658
2014,1,2014-01,AA,American Airlines Inc.,SAN,"San Diego, CA: San Diego International",453,131,322
2014,1,2014-01,AS,Alaska Airlines Inc.,SAN,"San Diego, CA: San Diego International",425,49,376
2014,1,2014-01,B6,JetBlue Airways,SAN,"San Diego, CA: San Diego International",100,24,76
2014,1,2014-01,DL,Delta Air Lines Inc.,SAN,"San Diego, CA: San Diego International",437,106,331
2014,1,2014-01,F9,Frontier Airlines Inc.,SAN,"San Diego, CA: San Diego International",117,42,75
2014,1,2014-01,HA,Hawaiian Airlines Inc.,SAN,"San Diego, CA: San Diego International",31,1,30
2014,1,2014-01,MQ,American Eagle Airlines Inc.,SAN,"San Diego, CA: San Diego International",140,38,102
2014,1,2014-01,OO,SkyWest Airlines Inc.,SAN,"San Diego, CA: San Diego International",702,144,558
2014,1,2014-01,UA,United Air Lines Inc.,SAN,"San Diego, CA: San Diego International",739,195,544
2014,1,2014-01,US,US Airways Inc.,SAN,"San Diego, CA: San Diego International",338,63,275
2014,1,2014-01,VX,Virgin America,SAN,"San Diego, CA: San Diego International",143,13,130
2014,1,2014-01,WN,Southwest Airlines Co.,SAN,"San Diego, CA: San Diego International",2461,760,1701
2014,2,2014-02,AA,American Airlines Inc.,SAN,"San Diego, CA: San Diego International",408,117,291
2014,2,2014-02,AS,Alaska Airlines Inc.,SAN,"San Diego, CA: San Diego International",380,53,327
2014,2,2014-02,B6,JetBlue Airways,SAN,"San Diego, CA: San Diego International",98,52,46
2014,2,2014-02,DL,Delta Air Lines Inc.,SAN,"San Diego, CA: San Diego International",399,77,322
2014,2,2014-02,F9,Frontier Airlines Inc.,SAN,"San Diego, CA: San Diego International",105,49,56
2014,2,2014-02,HA,Hawaiian Airlines Inc.,SAN,"San Diego, CA: San Diego International",28,0,28
2014,2,2014-02,MQ,American Eagle Airlines Inc.,SAN,"San Diego, CA: San Diego International",132,34,98
2014,2,2014-02,OO,SkyWest Airlines Inc.,SAN,"San Diego, CA: San Diego International",625,137,488
2014,2,2014-02,UA,United Air Lines Inc.,SAN,"San Diego, CA: San Diego International",635,198,437
2014,2,2014-02,US,US Airways Inc.,SAN,"San Diego, CA: San Diego International",284,73,211
2014,2,2014-02,VX,Virgin America,SAN,"San Diego, CA: San Diego International",124,22,102
2014,2,2014-02,WN,Southwest Airlines Co.,SAN,"San Diego, CA: San Diego International",2267,703,1564
2014,3,2014-03,AA,American Airlines Inc.,SAN,"San Diego, CA: San Diego International",451,98,353
2014,3,2014-03,AS,Alaska Airlines Inc.,SAN,"San Diego, CA: San Diego International",446,32,414
2014,3,2014-03,B6,JetBlue Airways,SAN,"San Diego, CA: San Diego International",115,31,84
2014,3,2014-03,DL,Delta Air Lines Inc.,SAN,"San Diego, CA: San Diego International",535,71,464
2014,3,2014-03,F9,Frontier Airlines Inc.,SAN,"San Diego, CA: San Diego International",124,32,92
2014,3,2014-03,MQ,American Eagle Airlines Inc.,SAN,"San Diego, CA: San Diego International",94,23,71
2014,3,2014-03,OO,SkyWest Airlines Inc.,SAN,"San Diego, CA: San Diego International",839,158,681
2014,3,2014-03,HA,Hawaiian Airlines Inc.,SAN,"San Diego, CA: San Diego International",31,3,28
2014,3,2014-03,UA,United Air Lines Inc.,SAN,"San Diego, CA: San Diego International",665,140,525
2014,3,2014-03,US,US Airways Inc.,SAN,"San Diego, CA: San Diego International",328,46,282
2014,3,2014-03,VX,Virgin America,SAN,"San Diego, CA: San Diego International",135,19,116
2014,3,2014-03,WN,Southwest Airlines Co.,SAN,"San Diego, CA: San Diego International",2667,673,1994
2014,4,2014-04,AA,American Airlines Inc.,SAN,"San Diego, CA: San Diego International",437,85,352
2014,4,2014-04,AS,Alaska Airlines Inc.,SAN,"San Diego, CA: San Diego International",437,38,399
2014,4,2014-04,B6,JetBlue Airways,SAN,"San Diego, CA: San Diego International",112,24,88
2014,4,2014-04,DL,Delta Air Lines Inc.,SAN,"San Diego, CA: San Diego International",501,71,430
2014,4,2014-04,F9,Frontier Airlines Inc.,SAN,"San Diego, CA: San Diego International",119,28,91
2014,4,2014-04,HA,Hawaiian Airlines Inc.,SAN,"San Diego, CA: San Diego International",30,2,28
2014,4,2014-04,MQ,Envoy Air,SAN,"San Diego, CA: San Diego International",76,15,61
2014,4,2014-04,OO,SkyWest Airlines Inc.,SAN,"San Diego, CA: San Diego International",722,118,604
2014,4,2014-04,UA,United Air Lines Inc.,SAN,"San Diego, CA: San Diego International",675,89,586
2014,4,2014-04,US,US Airways Inc.,SAN,"San Diego, CA: San Diego International",307,53,254
2014,4,2014-04,VX,Virgin America,SAN,"San Diego, CA: San Diego International",134,10,124
2014,4,2014-04,WN,Southwest Airlines Co.,SAN,"San Diego, CA: San Diego International",2705,759,1946
2014,5,2014-05,AA,American Airlines Inc.,SAN,"San Diego, CA: San Diego International",455,101,354
2014,5,2014-05,AS,Alaska Airlines Inc.,SAN,"San Diego, CA: San Diego International",457,30,427
2014,5,2014-05,B6,JetBlue Airways,SAN,"San Diego, CA: San Diego International",114,22,92
2014,5,2014-05,DL,Delta Air Lines Inc.,SAN,"San Diego, CA: San Diego International",479,55,424
2014,5,2014-05,F9,Frontier Airlines Inc.,SAN,"San Diego, CA: San Diego International",125,25,100
2014,5,2014-05,HA,Hawaiian Airlines Inc.,SAN,"San Diego, CA: San Diego International",31,1,30
2014,5,2014-05,MQ,Envoy Air,SAN,"San Diego, CA: San Diego International",42,4,38
2014,5,2014-05,OO,SkyWest Airlines Inc.,SAN,"San Diego, CA: San Diego International",790,108,682
2014,5,2014-05,UA,United Air Lines Inc.,SAN,"San Diego, CA: San Diego International",719,138,581
2014,5,2014-05,US,US Airways Inc.,SAN,"San Diego, CA: San Diego International",334,64,270
2014,5,2014-05,VX,Virgin America,SAN,"San Diego, CA: San Diego International",144,19,125
2014,5,2014-05,WN,Southwest Airlines Co.,SAN,"San Diego, CA: San Diego International",2760,775,1985
2014,6,2014-06,AA,American Airlines Inc.,SAN,"San Diego, CA: San Diego International",486,194,292
2014,6,2014-06,AS,Alaska Airlines Inc.,SAN,"San Diego, CA: San Diego International",499,29,470
2014,6,2014-06,B6,JetBlue Airways,SAN,"San Diego, CA: San Diego International",116,27,89
2014,6,2014-06,DL,Delta Air Lines Inc.,SAN,"San Diego, CA: San Diego International",546,87,459
2014,6,2014-06,F9,Frontier Airlines Inc.,SAN,"San Diego, CA: San Diego International",116,30,86
2014,6,2014-06,HA,Hawaiian Airlines Inc.,SAN,"San Diego, CA: San Diego International",30,0,30
2014,6,2014-06,MQ,Envoy Air,SAN,"San Diego, CA: San Diego International",10,2,8
2014,6,2014-06,OO,SkyWest Airlines Inc.,SAN,"San Diego, CA: San Diego International",862,112,750
2014,6,2014-06,UA,United Air Lines Inc.,SAN,"San Diego, CA: San Diego International",729,221,508
2014,6,2014-06,US,US Airways Inc.,SAN,"San Diego, CA: San Diego International",325,96,229
2014,6,2014-06,VX,Virgin America,SAN,"San Diego, CA: San Diego International",141,13,128
2014,6,2014-06,WN,Southwest Airlines Co.,SAN,"San Diego, CA: San Diego International",2882,968,1914
2014,7,2014-07,AA,American Airlines Inc.,SAN,"San Diego, CA: San Diego International",518,150,368
2014,7,2014-07,AS,Alaska Airlines Inc.,SAN,"San Diego, CA: San Diego International",535,64,471
2014,7,2014-07,B6,JetBlue Airways,SAN,"San Diego, CA: San Diego International",123,38,85
2014,7,2014-07,DL,Delta Air Lines Inc.,SAN,"San Diego, CA: San Diego International",634,69,565
2014,7,2014-07,F9,Frontier Airlines Inc.,SAN,"San Diego, CA: San Diego International",120,15,105
2014,7,2014-07,HA,Hawaiian Airlines Inc.,SAN,"San Diego, CA: San Diego International",31,6,25
2014,7,2014-07,OO,SkyWest Airlines Inc.,SAN,"San Diego, CA: San Diego International",904,135,769
2014,7,2014-07,UA,United Air Lines Inc.,SAN,"San Diego, CA: San Diego International",820,187,633
2014,7,2014-07,US,US Airways Inc.,SAN,"San Diego, CA: San Diego International",338,83,255
2014,7,2014-07,VX,Virgin America,SAN,"San Diego, CA: San Diego International",146,16,130
2014,7,2014-07,WN,Southwest Airlines Co.,SAN,"San Diego, CA: San Diego International",3024,895,2129
2014,8,2014-08,AA,American Airlines Inc.,SAN,"San Diego, CA: San Diego International",493,151,342
2014,8,2014-08,AS,Alaska Airlines Inc.,SAN,"San Diego, CA: San Diego International",515,50,465
2014,8,2014-08,B6,JetBlue Airways,SAN,"San Diego, CA: San Diego International",124,23,101
2014,8,2014-08,DL,Delta Air Lines Inc.,SAN,"San Diego, CA: San Diego International",699,96,603
2014,8,2014-08,F9,Frontier Airlines Inc.,SAN,"San Diego, CA: San Diego International",118,23,95
2014,8,2014-08,HA,Hawaiian Airlines Inc.,SAN,"San Diego, CA: San Diego International",31,6,25
2014,8,2014-08,OO,SkyWest Airlines Inc.,SAN,"San Diego, CA: San Diego International",892,131,761
2014,8,2014-08,UA,United Air Lines Inc.,SAN,"San Diego, CA: San Diego International",748,146,602
2014,8,2014-08,US,US Airways Inc.,SAN,"San Diego, CA: San Diego International",320,53,267
2014,8,2014-08,VX,Virgin America,SAN,"San Diego, CA: San Diego International",142,16,126
2014,8,2014-08,WN,Southwest Airlines Co.,SAN,"San Diego, CA: San Diego International",2846,656,2190
2014,9,2014-09,AA,American Airlines Inc.,SAN,"San Diego, CA: San Diego International",442,87,355
2014,9,2014-09,AS,Alaska Airlines Inc.,SAN,"San Diego, CA: San Diego International",445,52,393
2014,9,2014-09,B6,JetBlue Airways,SAN,"San Diego, CA: San Diego International",113,16,97
2014,9,2014-09,DL,Delta Air Lines Inc.,SAN,"San Diego, CA: San Diego International",491,79,412
2014,9,2014-09,F9,Frontier Airlines Inc.,SAN,"San Diego, CA: San Diego International",115,17,98
2014,9,2014-09,HA,Hawaiian Airlines Inc.,SAN,"San Diego, CA: San Diego International",30,7,23
2014,9,2014-09,OO,SkyWest Airlines Inc.,SAN,"San Diego, CA: San Diego International",826,89,737
2014,9,2014-09,UA,United Air Lines Inc.,SAN,"San Diego, CA: San Diego International",661,112,549
2014,9,2014-09,US,US Airways Inc.,SAN,"San Diego, CA: San Diego International",254,36,218
2014,9,2014-09,VX,Virgin America,SAN,"San Diego, CA: San Diego International",140,17,123
2014,9,2014-09,WN,Southwest Airlines Co.,SAN,"San Diego, CA: San Diego International",2711,434,2277
2014,10,2014-10,AA,American Airlines Inc.,SAN,"San Diego, CA: San Diego International",459,117,342
2014,10,2014-10,AS,Alaska Airlines Inc.,SAN,"San Diego, CA: San Diego International",461,62,399
2014,10,2014-10,B6,JetBlue Airways,SAN,"San Diego, CA: San Diego International",118,11,107
2014,10,2014-10,DL,Delta Air Lines Inc.,SAN,"San Diego, CA: San Diego International",523,55,468
2014,10,2014-10,F9,Frontier Airlines Inc.,SAN,"San Diego, CA: San Diego International",127,8,119
2014,10,2014-10,HA,Hawaiian Airlines Inc.,SAN,"San Diego, CA: San Diego International",31,10,21
2014,10,2014-10,OO,SkyWest Airlines Inc.,SAN,"San Diego, CA: San Diego International",886,122,764
2014,10,2014-10,UA,United Air Lines Inc.,SAN,"San Diego, CA: San Diego International",691,136,555
2014,10,2014-10,US,US Airways Inc.,SAN,"San Diego, CA: San Diego International",280,45,235
2014,10,2014-10,VX,Virgin America,SAN,"San Diego, CA: San Diego International",142,25,117
2014,10,2014-10,WN,Southwest Airlines Co.,SAN,"San Diego, CA: San Diego International",2810,411,2399
2014,11,2014-11,AA,American Airlines Inc.,SAN,"San Diego, CA: San Diego International",430,102,328
2014,11,2014-11,AS,Alaska Airlines Inc.,SAN,"San Diego, CA: San Diego International",424,51,373
2014,11,2014-11,B6,JetBlue Airways,SAN,"San Diego, CA: San Diego International",105,6,99
2014,11,2014-11,DL,Delta Air Lines Inc.,SAN,"San Diego, CA: San Diego International",464,57,407
2014,11,2014-11,F9,Frontier Airlines Inc.,SAN,"San Diego, CA: San Diego International",110,26,84
2014,11,2014-11,HA,Hawaiian Airlines Inc.,SAN,"San Diego, CA: San Diego International",30,5,25
2014,11,2014-11,OO,SkyWest Airlines Inc.,SAN,"San Diego, CA: San Diego International",702,122,580
2014,11,2014-11,UA,United Air Lines Inc.,SAN,"San Diego, CA: San Diego International",665,78,587
2014,11,2014-11,US,US Airways Inc.,SAN,"San Diego, CA: San Diego International",260,31,229
2014,11,2014-11,VX,Virgin America,SAN,"San Diego, CA: San Diego International",140,20,120
2014,11,2014-11,WN,Southwest Airlines Co.,SAN,"San Diego, CA: San Diego International",2738,485,2253
2014,12,2014-12,AA,American Airlines Inc.,SAN,"San Diego, CA: San Diego International",462,128,334
2014,12,2014-12,AS,Alaska Airlines Inc.,SAN,"San Diego, CA: San Diego International",451,72,379
2014,12,2014-12,B6,JetBlue Airways,SAN,"San Diego, CA: San Diego International",113,18,95
2014,12,2014-12,DL,Delta Air Lines Inc.,SAN,"San Diego, CA: San Diego International",512,63,449
2014,12,2014-12,F9,Frontier Airlines Inc.,SAN,"San Diego, CA: San Diego International",102,35,67
2014,12,2014-12,HA,Hawaiian Airlines Inc.,SAN,"San Diego, CA: San Diego International",31,7,24
2014,12,2014-12,OO,SkyWest Airlines Inc.,SAN,"San Diego, CA: San Diego International",775,236,539
2014,12,2014-12,UA,United Air Lines Inc.,SAN,"San Diego, CA: San Diego International",634,179,455
2014,12,2014-12,US,US Airways Inc.,SAN,"San Diego, CA: San Diego International",276,40,236
2014,12,2014-12,VX,Virgin America,SAN,"San Diego, CA: San Diego International",145,38,107
2014,12,2014-12,WN,Southwest Airlines Co.,SAN,"San Diego, CA: San Diego International",2838,930,1908
2015,1,2015-01,AA,American Airlines Inc.,SAN,"San Diego, CA: San Diego International",436,85,351
2015,1,2015-01,AS,Alaska Airlines Inc.,SAN,"San Diego, CA: San Diego International",439,54,385
2015,1,2015-01,B6,JetBlue Airways,SAN,"San Diego, CA: San Diego International",98,18,80
2015,1,2015-01,DL,Delta Air Lines Inc.,SAN,"San Diego, CA: San Diego International",455,37,418
2015,1,2015-01,F9,Frontier Airlines Inc.,SAN,"San Diego, CA: San Diego International",73,20,53
2015,1,2015-01,HA,Hawaiian Airlines Inc.,SAN,"San Diego, CA: San Diego International",31,5,26
2015,1,2015-01,NK,Spirit Air Lines,SAN,"San Diego, CA: San Diego International",128,26,102
2015,1,2015-01,OO,SkyWest Airlines Inc.,SAN,"San Diego, CA: San Diego International",716,126,590
2015,1,2015-01,UA,United Air Lines Inc.,SAN,"San Diego, CA: San Diego International",570,104,466
2015,1,2015-01,US,US Airways Inc.,SAN,"San Diego, CA: San Diego International",279,35,244
2015,1,2015-01,VX,Virgin America,SAN,"San Diego, CA: San Diego International",138,16,122
2015,1,2015-01,WN,Southwest Airlines Co.,SAN,"San Diego, CA: San Diego International",2721,504,2217
2015,2,2015-02,AA,American Airlines Inc.,SAN,"San Diego, CA: San Diego International",387,88,299
2015,2,2015-02,AS,Alaska Airlines Inc.,SAN,"San Diego, CA: San Diego International",392,51,341
2015,2,2015-02,B6,JetBlue Airways,SAN,"San Diego, CA: San Diego International",99,32,67
2015,2,2015-02,DL,Delta Air Lines Inc.,SAN,"San Diego, CA: San Diego International",395,78,317
2015,2,2015-02,F9,Frontier Airlines Inc.,SAN,"San Diego, CA: San Diego International",52,17,35
2015,2,2015-02,NK,Spirit Air Lines,SAN,"San Diego, CA: San Diego International",112,17,95
2015,2,2015-02,OO,SkyWest Airlines Inc.,SAN,"San Diego, CA: San Diego International",647,135,512
2015,2,2015-02,HA,Hawaiian Airlines Inc.,SAN,"San Diego, CA: San Diego International",28,5,23
2015,2,2015-02,UA,United Air Lines Inc.,SAN,"San Diego, CA: San Diego International",530,123,407
2015,2,2015-02,US,US Airways Inc.,SAN,"San Diego, CA: San Diego International",250,61,189
2015,2,2015-02,VX,Virgin America,SAN,"San Diego, CA: San Diego International",122,22,100
2015,2,2015-02,WN,Southwest Airlines Co.,SAN,"San Diego, CA: San Diego International",2464,490,1974
2015,3,2015-03,AA,American Airlines Inc.,SAN,"San Diego, CA: San Diego International",463,95,368
2015,3,2015-03,AS,Alaska Airlines Inc.,SAN,"San Diego, CA: San Diego International",467,51,416
2015,3,2015-03,B6,JetBlue Airways,SAN,"San Diego, CA: San Diego International",120,25,95
2015,3,2015-03,DL,Delta Air Lines Inc.,SAN,"San Diego, CA: San Diego International",556,72,484
2015,3,2015-03,F9,Frontier Airlines Inc.,SAN,"San Diego, CA: San Diego International",61,12,49
2015,3,2015-03,HA,Hawaiian Airlines Inc.,SAN,"San Diego, CA: San Diego International",31,5,26
2015,3,2015-03,NK,Spirit Air Lines,SAN,"San Diego, CA: San Diego International",155,20,135
2015,3,2015-03,OO,SkyWest Airlines Inc.,SAN,"San Diego, CA: San Diego International",704,135,569
2015,3,2015-03,UA,United Air Lines Inc.,SAN,"San Diego, CA: San Diego International",684,113,571
2015,3,2015-03,US,US Airways Inc.,SAN,"San Diego, CA: San Diego International",292,42,250
2015,3,2015-03,VX,Virgin America,SAN,"San Diego, CA: San Diego International",138,10,128
2015,3,2015-03,WN,Southwest Airlines Co.,SAN,"San Diego, CA: San Diego International",2918,459,2459
2015,4,2015-04,AA,American Airlines Inc.,SAN,"San Diego, CA: San Diego International",458,120,338
2015,4,2015-04,AS,Alaska Airlines Inc.,SAN,"San Diego, CA: San Diego International",462,39,423
2015,4,2015-04,B6,JetBlue Airways,SAN,"San Diego, CA: San Diego International",116,24,92
2015,4,2015-04,DL,Delta Air Lines Inc.,SAN,"San Diego, CA: San Diego International",526,73,453
2015,4,2015-04,F9,Frontier Airlines Inc.,SAN,"San Diego, CA: San Diego International",76,12,64
2015,4,2015-04,HA,Hawaiian Airlines Inc.,SAN,"San Diego, CA: San Diego International",30,3,27
2015,4,2015-04,NK,Spirit Air Lines,SAN,"San Diego, CA: San Diego International",165,38,127
2015,4,2015-04,OO,SkyWest Airlines Inc.,SAN,"San Diego, CA: San Diego International",609,108,501
2015,4,2015-04,UA,United Air Lines Inc.,SAN,"San Diego, CA: San Diego International",678,148,530
2015,4,2015-04,US,US Airways Inc.,SAN,"San Diego, CA: San Diego International",269,57,212
2015,4,2015-04,VX,Virgin America,SAN,"San Diego, CA: San Diego International",135,15,120
2015,4,2015-04,WN,Southwest Airlines Co.,SAN,"San Diego, CA: San Diego International",2898,539,2359
2015,5,2015-05,AA,American Airlines Inc.,SAN,"San Diego, CA: San Diego International",461,113,348
2015,5,2015-05,AS,Alaska Airlines Inc.,SAN,"San Diego, CA: San Diego International",479,47,432
2015,5,2015-05,B6,JetBlue Airways,SAN,"San Diego, CA: San Diego International",119,20,99
2015,5,2015-05,DL,Delta Air Lines Inc.,SAN,"San Diego, CA: San Diego International",518,70,448
2015,5,2015-05,F9,Frontier Airlines Inc.,SAN,"San Diego, CA: San Diego International",83,13,70
2015,5,2015-05,HA,Hawaiian Airlines Inc.,SAN,"San Diego, CA: San Diego International",31,1,30
2015,5,2015-05,NK,Spirit Air Lines,SAN,"San Diego, CA: San Diego International",187,61,126
2015,5,2015-05,OO,SkyWest Airlines Inc.,SAN,"San Diego, CA: San Diego International",554,82,472
2015,5,2015-05,UA,United Air Lines Inc.,SAN,"San Diego, CA: San Diego International",754,165,589
2015,5,2015-05,US,US Airways Inc.,SAN,"San Diego, CA: San Diego International",309,46,263
2015,5,2015-05,VX,Virgin America,SAN,"San Diego, CA: San Diego International",163,46,117
2015,5,2015-05,WN,Southwest Airlines Co.,SAN,"San Diego, CA: San Diego International",2937,602,2335
2015,6,2015-06,AA,American Airlines Inc.,SAN,"San Diego, CA: San Diego International",475,103,372
2015,6,2015-06,AS,Alaska Airlines Inc.,SAN,"San Diego, CA: San Diego International",500,55,445
2015,6,2015-06,B6,JetBlue Airways,SAN,"San Diego, CA: San Diego International",118,9,109
2015,6,2015-06,DL,Delta Air Lines Inc.,SAN,"San Diego, CA: San Diego International",591,81,510
2015,6,2015-06,F9,Frontier Airlines Inc.,SAN,"San Diego, CA: San Diego International",84,20,64
2015,6,2015-06,HA,Hawaiian Airlines Inc.,SAN,"San Diego, CA: San Diego International",30,6,24
2015,6,2015-06,NK,Spirit Air Lines,SAN,"San Diego, CA: San Diego International",180,53,127
2015,6,2015-06,OO,SkyWest Airlines Inc.,SAN,"San Diego, CA: San Diego International",571,118,453
2015,6,2015-06,UA,United Air Lines Inc.,SAN,"San Diego, CA: San Diego International",777,224,553
2015,6,2015-06,US,US Airways Inc.,SAN,"San Diego, CA: San Diego International",323,55,268
2015,6,2015-06,VX,Virgin America,SAN,"San Diego, CA: San Diego International",172,22,150
2015,6,2015-06,WN,Southwest Airlines Co.,SAN,"San Diego, CA: San Diego International",2942,733,2209
2015,7,2015-07,AA,American Airlines Inc.,SAN,"San Diego, CA: San Diego International",855,138,717
2015,7,2015-07,AS,Alaska Airlines Inc.,SAN,"San Diego, CA: San Diego International",538,57,481
2015,7,2015-07,B6,JetBlue Airways,SAN,"San Diego, CA: San Diego International",124,24,100
2015,7,2015-07,DL,Delta Air Lines Inc.,SAN,"San Diego, CA: San Diego International",631,93,538
2015,7,2015-07,F9,Frontier Airlines Inc.,SAN,"San Diego, CA: San Diego International",65,14,51
2015,7,2015-07,HA,Hawaiian Airlines Inc.,SAN,"San Diego, CA: San Diego International",31,12,19
2015,7,2015-07,NK,Spirit Air Lines,SAN,"San Diego, CA: San Diego International",186,40,146
2015,7,2015-07,OO,SkyWest Airlines Inc.,SAN,"San Diego, CA: San Diego International",630,176,454
2015,7,2015-07,UA,United Air Lines Inc.,SAN,"San Diego, CA: San Diego International",793,181,612
2015,7,2015-07,VX,Virgin America,SAN,"San Diego, CA: San Diego International",176,30,146
2015,7,2015-07,WN,Southwest Airlines Co.,SAN,"San Diego, CA: San Diego International",3002,799,2203
2015,8,2015-08,AA,American Airlines Inc.,SAN,"San Diego, CA: San Diego International",831,132,699
2015,8,2015-08,AS,Alaska Airlines Inc.,SAN,"San Diego, CA: San Diego International",517,67,450
2015,8,2015-08,B6,JetBlue Airways,SAN,"San Diego, CA: San Diego International",124,24,100
2015,8,2015-08,DL,Delta Air Lines Inc.,SAN,"San Diego, CA: San Diego International",643,92,551
2015,8,2015-08,F9,Frontier Airlines Inc.,SAN,"San Diego, CA: San Diego International",61,6,55
2015,8,2015-08,HA,Hawaiian Airlines Inc.,SAN,"San Diego, CA: San Diego International",31,4,27
2015,8,2015-08,NK,Spirit Air Lines,SAN,"San Diego, CA: San Diego International",186,34,152
2015,8,2015-08,OO,SkyWest Airlines Inc.,SAN,"San Diego, CA: San Diego International",644,130,514
2015,8,2015-08,UA,United Air Lines Inc.,SAN,"San Diego, CA: San Diego International",775,132,643
2015,8,2015-08,VX,Virgin America,SAN,"San Diego, CA: San Diego International",183,26,157
2015,8,2015-08,WN,Southwest Airlines Co.,SAN,"San Diego, CA: San Diego International",2881,565,2316
2015,9,2015-09,AA,American Airlines Inc.,SAN,"San Diego, CA: San Diego International",701,99,602
2015,9,2015-09,AS,Alaska Airlines Inc.,SAN,"San Diego, CA: San Diego International",455,41,414
2015,9,2015-09,B6,JetBlue Airways,SAN,"San Diego, CA: San Diego International",113,15,98
2015,9,2015-09,DL,Delta Air Lines Inc.,SAN,"San Diego, CA: San Diego International",498,30,468
2015,9,2015-09,F9,Frontier Airlines Inc.,SAN,"San Diego, CA: San Diego International",82,9,73
2015,9,2015-09,HA,Hawaiian Airlines Inc.,SAN,"San Diego, CA: San Diego International",30,11,19
2015,9,2015-09,NK,Spirit Air Lines,SAN,"San Diego, CA: San Diego International",180,27,153
2015,9,2015-09,OO,SkyWest Airlines Inc.,SAN,"San Diego, CA: San Diego International",630,107,523
2015,9,2015-09,UA,United Air Lines Inc.,SAN,"San Diego, CA: San Diego International",703,72,631
2015,9,2015-09,VX,Virgin America,SAN,"San Diego, CA: San Diego International",169,8,161
2015,9,2015-09,WN,Southwest Airlines Co.,SAN,"San Diego, CA: San Diego International",2612,303,2309
2015,10,2015-10,AA,American Airlines Inc.,SAN,"San Diego, CA: San Diego International",721,83,638
2015,10,2015-10,AS,Alaska Airlines Inc.,SAN,"San Diego, CA: San Diego International",475,40,435
2015,10,2015-10,B6,JetBlue Airways,SAN,"San Diego, CA: San Diego International",118,15,103
2015,10,2015-10,DL,Delta Air Lines Inc.,SAN,"San Diego, CA: San Diego International",512,29,483
2015,10,2015-10,F9,Frontier Airlines Inc.,SAN,"San Diego, CA: San Diego International",106,10,96
2015,10,2015-10,NK,Spirit Air Lines,SAN,"San Diego, CA: San Diego International",186,25,161
2015,10,2015-10,OO,SkyWest Airlines Inc.,SAN,"San Diego, CA: San Diego International",434,48,386
2015,10,2015-10,HA,Hawaiian Airlines Inc.,SAN,"San Diego, CA: San Diego International",31,7,24
2015,10,2015-10,UA,United Air Lines Inc.,SAN,"San Diego, CA: San Diego International",764,83,681
2015,10,2015-10,VX,Virgin America,SAN,"San Diego, CA: San Diego International",177,18,159
2015,10,2015-10,WN,Southwest Airlines Co.,SAN,"San Diego, CA: San Diego International",2683,303,2380
2015,11,2015-11,AA,American Airlines Inc.,SAN,"San Diego, CA: San Diego International",693,137,556
2015,11,2015-11,AS,Alaska Airlines Inc.,SAN,"San Diego, CA: San Diego International",428,50,378
2015,11,2015-11,B6,JetBlue Airways,SAN,"San Diego, CA: San Diego International",110,15,95
2015,11,2015-11,DL,Delta Air Lines Inc.,SAN,"San Diego, CA: San Diego International",497,56,441
2015,11,2015-11,F9,Frontier Airlines Inc.,SAN,"San Diego, CA: San Diego International",53,11,42
2015,11,2015-11,HA,Hawaiian Airlines Inc.,SAN,"San Diego, CA: San Diego International",30,3,27
2015,11,2015-11,NK,Spirit Air Lines,SAN,"San Diego, CA: San Diego International",180,56,124
2015,11,2015-11,OO,SkyWest Airlines Inc.,SAN,"San Diego, CA: San Diego International",371,53,318
2015,11,2015-11,UA,United Air Lines Inc.,SAN,"San Diego, CA: San Diego International",718,98,620
2015,11,2015-11,VX,Virgin America,SAN,"San Diego, CA: San Diego International",170,29,141
2015,11,2015-11,WN,Southwest Airlines Co.,SAN,"San Diego, CA: San Diego International",2715,489,2226
2015,12,2015-12,AA,American Airlines Inc.,SAN,"San Diego, CA: San Diego International",789,165,624
2015,12,2015-12,AS,Alaska Airlines Inc.,SAN,"San Diego, CA: San Diego International",462,66,396
2015,12,2015-12,B6,JetBlue Airways,SAN,"San Diego, CA: San Diego International",116,27,89
2015,12,2015-12,DL,Delta Air Lines Inc.,SAN,"San Diego, CA: San Diego International",544,84,460
2015,12,2015-12,F9,Frontier Airlines Inc.,SAN,"San Diego, CA: San Diego International",56,9,47
2015,12,2015-12,HA,Hawaiian Airlines Inc.,SAN,"San Diego, CA: San Diego International",31,5,26
2015,12,2015-12,NK,Spirit Air Lines,SAN,"San Diego, CA: San Diego International",186,63,123
2015,12,2015-12,OO,SkyWest Airlines Inc.,SAN,"San Diego, CA: San Diego International",361,79,282
2015,12,2015-12,UA,United Air Lines Inc.,SAN,"San Diego, CA: San Diego International",716,153,563
2015,12,2015-12,VX,Virgin America,SAN,"San Diego, CA: San Diego International",176,49,127
2015,12,2015-12,WN,Southwest Airlines Co.,SAN,"San Diego, CA: San Diego International",2794,683,2111
2016,1,2016-01,AA,American Airlines Inc.,SAN,"San Diego, CA: San Diego International",718,112,606
2016,1,2016-01,AS,Alaska Airlines Inc.,SAN,"San Diego, CA: San Diego International",448,51,397
2016,1,2016-01,B6,JetBlue Airways,SAN,"San Diego, CA: San Diego International",108,18,90
2016,1,2016-01,DL,Delta Air Lines Inc.,SAN,"San Diego, CA: San Diego International",503,48,455
2016,1,2016-01,F9,Frontier Airlines Inc.,SAN,"San Diego, CA: San Diego International",60,7,53
2016,1,2016-01,HA,Hawaiian Airlines Inc.,SAN,"San Diego, CA: San Diego International",31,1,30
2016,1,2016-01,NK,Spirit Air Lines,SAN,"San Diego, CA: San Diego International",186,52,134
2016,1,2016-01,OO,SkyWest Airlines Inc.,SAN,"San Diego, CA: San Diego International",392,68,324
2016,1,2016-01,UA,United Air Lines Inc.,SAN,"San Diego, CA: San Diego International",640,58,582
2016,1,2016-01,VX,Virgin America,SAN,"San Diego, CA: San Diego International",164,48,116
2016,1,2016-01,WN,Southwest Airlines Co.,SAN,"San Diego, CA: San Diego International",2766,408,2358
2016,2,2016-02,AA,American Airlines Inc.,SAN,"San Diego, CA: San Diego International",686,102,584
2016,2,2016-02,AS,Alaska Airlines Inc.,SAN,"San Diego, CA: San Diego International",415,42,373
2016,2,2016-02,B6,JetBlue Airways,SAN,"San Diego, CA: San Diego International",104,15,89
2016,2,2016-02,DL,Delta Air Lines Inc.,SAN,"San Diego, CA: San Diego International",490,44,446
2016,2,2016-02,F9,Frontier Airlines Inc.,SAN,"San Diego, CA: San Diego International",70,4,66
2016,2,2016-02,HA,Hawaiian Airlines Inc.,SAN,"San Diego, CA: San Diego International",29,3,26
2016,2,2016-02,NK,Spirit Air Lines,SAN,"San Diego, CA: San Diego International",171,52,119
2016,2,2016-02,OO,SkyWest Airlines Inc.,SAN,"San Diego, CA: San Diego International",388,67,321
2016,2,2016-02,UA,United Air Lines Inc.,SAN,"San Diego, CA: San Diego International",583,62,521
2016,2,2016-02,VX,Virgin America,SAN,"San Diego, CA: San Diego International",153,22,131
2016,2,2016-02,WN,Southwest Airlines Co.,SAN,"San Diego, CA: San Diego International",2596,253,2343
2016,3,2016-03,AA,American Airlines Inc.,SAN,"San Diego, CA: San Diego International",802,125,677
2016,3,2016-03,AS,Alaska Airlines Inc.,SAN,"San Diego, CA: San Diego International",463,40,423
2016,3,2016-03,B6,JetBlue Airways,SAN,"San Diego, CA: San Diego International",116,22,94
2016,3,2016-03,DL,Delta Air Lines Inc.,SAN,"San Diego, CA: San Diego International",614,80,534
2016,3,2016-03,F9,Frontier Airlines Inc.,SAN,"San Diego, CA: San Diego International",57,12,45
2016,3,2016-03,HA,Hawaiian Airlines Inc.,SAN,"San Diego, CA: San Diego International",31,0,31
2016,3,2016-03,NK,Spirit Air Lines,SAN,"San Diego, CA: San Diego International",186,74,112
2016,3,2016-03,OO,SkyWest Airlines Inc.,SAN,"San Diego, CA: San Diego International",444,99,345
2016,3,2016-03,UA,United Air Lines Inc.,SAN,"San Diego, CA: San Diego International",651,109,542
2016,3,2016-03,VX,Virgin America,SAN,"San Diego, CA: San Diego International",168,50,118
2016,3,2016-03,WN,Southwest Airlines Co.,SAN,"San Diego, CA: San Diego International",2915,485,2430
2016,4,2016-04,AA,American Airlines Inc.,SAN,"San Diego, CA: San Diego International",770,118,652
2016,4,2016-04,AS,Alaska Airlines Inc.,SAN,"San Diego, CA: San Diego International",467,34,433
2016,4,2016-04,B6,JetBlue Airways,SAN,"San Diego, CA: San Diego International",110,12,98
2016,4,2016-04,DL,Delta Air Lines Inc.,SAN,"San Diego, CA: San Diego International",632,42,590
2016,4,2016-04,F9,Frontier Airlines Inc.,SAN,"San Diego, CA: San Diego International",75,3,72
2016,4,2016-04,HA,Hawaiian Airlines Inc.,SAN,"San Diego, CA: San Diego International",30,8,22
2016,4,2016-04,NK,Spirit Air Lines,SAN,"San Diego, CA: San Diego International",180,48,132
2016,4,2016-04,OO,SkyWest Airlines Inc.,SAN,"San Diego, CA: San Diego International",438,42,396
2016,4,2016-04,UA,United Air Lines Inc.,SAN,"San Diego, CA: San Diego International",668,79,589
2016,4,2016-04,VX,Virgin America,SAN,"San Diego, CA: San Diego International",162,40,122
2016,4,2016-04,WN,Southwest Airlines Co.,SAN,"San Diego, CA: San Diego International",2845,529,2316
2016,5,2016-05,AA,American Airlines Inc.,SAN,"San Diego, CA: San Diego International",775,112,663
2016,5,2016-05,AS,Alaska Airlines Inc.,SAN,"San Diego, CA: San Diego International",480,37,443
2016,5,2016-05,B6,JetBlue Airways,SAN,"San Diego, CA: San Diego International",119,15,104
2016,5,2016-05,DL,Delta Air Lines Inc.,SAN,"San Diego, CA: San Diego International",615,63,552
2016,5,2016-05,F9,Frontier Airlines Inc.,SAN,"San Diego, CA: San Diego International",88,16,72
2016,5,2016-05,HA,Hawaiian Airlines Inc.,SAN,"San Diego, CA: San Diego International",31,4,27
2016,5,2016-05,NK,Spirit Air Lines,SAN,"San Diego, CA: San Diego International",186,29,157
2016,5,2016-05,OO,SkyWest Airlines Inc.,SAN,"San Diego, CA: San Diego International",446,70,376
2016,5,2016-05,UA,United Air Lines Inc.,SAN,"San Diego, CA: San Diego International",704,101,603
2016,5,2016-05,VX,Virgin America,SAN,"San Diego, CA: San Diego International",171,41,130
2016,5,2016-05,WN,Southwest Airlines Co.,SAN,"San Diego, CA: San Diego International",2956,597,2359
2016,6,2016-06,AA,American Airlines Inc.,SAN,"San Diego, CA: San Diego International",858,198,660
2016,6,2016-06,AS,Alaska Airlines Inc.,SAN,"San Diego, CA: San Diego International",504,57,447
2016,6,2016-06,B6,JetBlue Airways,SAN,"San Diego, CA: San Diego International",133,17,116
2016,6,2016-06,DL,Delta Air Lines Inc.,SAN,"San Diego, CA: San Diego International",633,96,537
2016,6,2016-06,F9,Frontier Airlines Inc.,SAN,"San Diego, CA: San Diego International",87,22,65
2016,6,2016-06,HA,Hawaiian Airlines Inc.,SAN,"San Diego, CA: San Diego International",30,5,25
2016,6,2016-06,NK,Spirit Air Lines,SAN,"San Diego, CA: San Diego International",180,36,144
2016,6,2016-06,OO,SkyWest Airlines Inc.,SAN,"San Diego, CA: San Diego International",585,93,492
2016,6,2016-06,UA,United Air Lines Inc.,SAN,"San Diego, CA: San Diego International",727,121,606
2016,6,2016-06,VX,Virgin America,SAN,"San Diego, CA: San Diego International",171,43,128
2016,6,2016-06,WN,Southwest Airlines Co.,SAN,"San Diego, CA: San Diego International",2968,676,2292
2016,7,2016-07,AA,American Airlines Inc.,SAN,"San Diego, CA: San Diego International",889,228,661
2016,7,2016-07,AS,Alaska Airlines Inc.,SAN,"San Diego, CA: San Diego International",528,45,483
2016,7,2016-07,B6,JetBlue Airways,SAN,"San Diego, CA: San Diego International",151,44,107
2016,7,2016-07,DL,Delta Air Lines Inc.,SAN,"San Diego, CA: San Diego International",723,104,619
2016,7,2016-07,F9,Frontier Airlines Inc.,SAN,"San Diego, CA: San Diego International",93,40,53
2016,7,2016-07,HA,Hawaiian Airlines Inc.,SAN,"San Diego, CA: San Diego International",31,3,28
2016,7,2016-07,NK,Spirit Air Lines,SAN,"San Diego, CA: San Diego International",186,44,142
2016,7,2016-07,OO,SkyWest Airlines Inc.,SAN,"San Diego, CA: San Diego International",609,98,511
2016,7,2016-07,UA,United Air Lines Inc.,SAN,"San Diego, CA: San Diego International",755,149,606
2016,7,2016-07,VX,Virgin America,SAN,"San Diego, CA: San Diego International",164,32,132
2016,7,2016-07,WN,Southwest Airlines Co.,SAN,"San Diego, CA: San Diego International",3032,670,2362
2016,8,2016-08,AA,American Airlines Inc.,SAN,"San Diego, CA: San Diego International",842,239,603
2016,8,2016-08,AS,Alaska Airlines Inc.,SAN,"San Diego, CA: San Diego International",530,39,491
2016,8,2016-08,B6,JetBlue Airways,SAN,"San Diego, CA: San Diego International",154,35,119
2016,8,2016-08,DL,Delta Air Lines Inc.,SAN,"San Diego, CA: San Diego International",684,113,571
2016,8,2016-08,F9,Frontier Airlines Inc.,SAN,"San Diego, CA: San Diego International",93,29,64
2016,8,2016-08,HA,Hawaiian Airlines Inc.,SAN,"San Diego, CA: San Diego International",31,7,24
2016,8,2016-08,NK,Spirit Air Lines,SAN,"San Diego, CA: San Diego International",186,49,137
2016,8,2016-08,OO,SkyWest Airlines Inc.,SAN,"San Diego, CA: San Diego International",564,101,463
2016,8,2016-08,UA,United Air Lines Inc.,SAN,"San Diego, CA: San Diego International",856,152,704
2016,8,2016-08,VX,Virgin America,SAN,"San Diego, CA: San Diego International",178,47,131
2016,8,2016-08,WN,Southwest Airlines Co.,SAN,"San Diego, CA: San Diego International",2997,452,2545
2016,9,2016-09,AA,American Airlines Inc.,SAN,"San Diego, CA: San Diego International",694,129,565
2016,9,2016-09,AS,Alaska Airlines Inc.,SAN,"San Diego, CA: San Diego International",461,35,426
2016,9,2016-09,B6,JetBlue Airways,SAN,"San Diego, CA: San Diego International",138,17,121
2016,9,2016-09,DL,Delta Air Lines Inc.,SAN,"San Diego, CA: San Diego International",547,40,507
2016,9,2016-09,F9,Frontier Airlines Inc.,SAN,"San Diego, CA: San Diego International",87,38,49
2016,9,2016-09,HA,Hawaiian Airlines Inc.,SAN,"San Diego, CA: San Diego International",30,6,24
2016,9,2016-09,NK,Spirit Air Lines,SAN,"San Diego, CA: San Diego International",180,19,161
2016,9,2016-09,OO,SkyWest Airlines Inc.,SAN,"San Diego, CA: San Diego International",539,61,478
2016,9,2016-09,UA,United Air Lines Inc.,SAN,"San Diego, CA: San Diego International",766,91,675
2016,9,2016-09,VX,Virgin America,SAN,"San Diego, CA: San Diego International",170,27,143
2016,9,2016-09,WN,Southwest Airlines Co.,SAN,"San Diego, CA: San Diego International",2825,369,2456
2016,10,2016-10,AA,American Airlines Inc.,SAN,"San Diego, CA: San Diego International",723,113,610
2016,10,2016-10,AS,Alaska Airlines Inc.,SAN,"San Diego, CA: San Diego International",475,39,436
2016,10,2016-10,B6,JetBlue Airways,SAN,"San Diego, CA: San Diego International",150,36,114
2016,10,2016-10,DL,Delta Air Lines Inc.,SAN,"San Diego, CA: San Diego International",571,27,544
2016,10,2016-10,F9,Frontier Airlines Inc.,SAN,"San Diego, CA: San Diego International",72,15,57
2016,10,2016-10,HA,Hawaiian Airlines Inc.,SAN,"San Diego, CA: San Diego International",31,4,27
2016,10,2016-10,NK,Spirit Air Lines,SAN,"San Diego, CA: San Diego International",186,19,167
2016,10,2016-10,OO,SkyWest Airlines Inc.,SAN,"San Diego, CA: San Diego International",522,68,454
2016,10,2016-10,UA,United Air Lines Inc.,SAN,"San Diego, CA: San Diego International",819,115,704
2016,10,2016-10,VX,Virgin America,SAN,"San Diego, CA: San Diego International",176,41,135
2016,10,2016-10,WN,Southwest Airlines Co.,SAN,"San Diego, CA: San Diego International",2915,442,2473
2016,11,2016-11,AA,American Airlines Inc.,SAN,"San Diego, CA: San Diego International",696,96,600
2016,11,2016-11,AS,Alaska Airlines Inc.,SAN,"San Diego, CA: San Diego International",445,49,396
2016,11,2016-11,B6,JetBlue Airways,SAN,"San Diego, CA: San Diego International",135,7,128
2016,11,2016-11,DL,Delta Air Lines Inc.,SAN,"San Diego, CA: San Diego International",523,33,490
2016,11,2016-11,F9,Frontier Airlines Inc.,SAN,"San Diego, CA: San Diego International",84,14,70
2016,11,2016-11,HA,Hawaiian Airlines Inc.,SAN,"San Diego, CA: San Diego International",30,9,21
2016,11,2016-11,NK,Spirit Air Lines,SAN,"San Diego, CA: San Diego International",138,12,126
2016,11,2016-11,OO,SkyWest Airlines Inc.,SAN,"San Diego, CA: San Diego International",532,74,458
2016,11,2016-11,UA,United Air Lines Inc.,SAN,"San Diego, CA: San Diego International",756,70,686
2016,11,2016-11,VX,Virgin America,SAN,"San Diego, CA: San Diego International",172,29,143
2016,11,2016-11,WN,Southwest Airlines Co.,SAN,"San Diego, CA: San Diego International",2805,383,2422
2016,12,2016-12,AA,American Airlines Inc.,SAN,"San Diego, CA: San Diego International",789,208,581
2016,12,2016-12,AS,Alaska Airlines Inc.,SAN,"San Diego, CA: San Diego International",484,128,356
2016,12,2016-12,B6,JetBlue Airways,SAN,"San Diego, CA: San Diego International",143,45,98
2016,12,2016-12,DL,Delta Air Lines Inc.,SAN,"San Diego, CA: San Diego International",550,138,412
2016,12,2016-12,F9,Frontier Airlines Inc.,SAN,"San Diego, CA: San Diego International",93,31,62
2016,12,2016-12,HA,Hawaiian Airlines Inc.,SAN,"San Diego, CA: San Diego International",31,6,25
2016,12,2016-12,NK,Spirit Air Lines,SAN,"San Diego, CA: San Diego International",124,54,70
2016,12,2016-12,OO,SkyWest Airlines Inc.,SAN,"San Diego, CA: San Diego International",548,156,392
2016,12,2016-12,UA,United Air Lines Inc.,SAN,"San Diego, CA: San Diego International",751,172,579
2016,12,2016-12,VX,Virgin America,SAN,"San Diego, CA: San Diego International",175,56,119
2016,12,2016-12,WN,Southwest Airlines Co.,SAN,"San Diego, CA: San Diego International",2860,799,2061
2017,1,2017-01,AA,American Airlines Inc.,SAN,"San Diego, CA: San Diego International",702,218,484
2017,1,2017-01,AS,Alaska Airlines Inc.,SAN,"San Diego, CA: San Diego International",481,108,373
2017,1,2017-01,B6,JetBlue Airways,SAN,"San Diego, CA: San Diego International",136,41,95
2017,1,2017-01,DL,Delta Air Lines Inc.,SAN,"San Diego, CA: San Diego International",510,139,371
2017,1,2017-01,F9,Frontier Airlines Inc.,SAN,"San Diego, CA: San Diego International",93,40,53
2017,1,2017-01,HA,Hawaiian Airlines Inc.,SAN,"San Diego, CA: San Diego International",31,9,22
2017,1,2017-01,NK,Spirit Air Lines,SAN,"San Diego, CA: San Diego International",124,35,89
2017,1,2017-01,OO,SkyWest Airlines Inc.,SAN,"San Diego, CA: San Diego International",545,127,418
2017,1,2017-01,UA,United Air Lines Inc.,SAN,"San Diego, CA: San Diego International",717,179,538
2017,1,2017-01,VX,Virgin America,SAN,"San Diego, CA: San Diego International",165,56,109
2017,1,2017-01,WN,Southwest Airlines Co.,SAN,"San Diego, CA: San Diego International",2818,791,2027
2017,2,2017-02,F9,Frontier Airlines Inc.,SAN,"San Diego, CA: San Diego International",84,16,68
2017,2,2017-02,HA,Hawaiian Airlines Inc.,SAN,"San Diego, CA: San Diego International",28,3,25
2017,2,2017-02,NK,Spirit Air Lines,SAN,"San Diego, CA: San Diego International",112,26,86
2017,2,2017-02,OO,SkyWest Airlines Inc.,SAN,"San Diego, CA: San Diego International",525,144,381
2017,2,2017-02,UA,United Air Lines Inc.,SAN,"San Diego, CA: San Diego International",644,124,520
2017,2,2017-02,VX,Virgin America,SAN,"San Diego, CA: San Diego International",148,50,98
2017,2,2017-02,AA,American Airlines Inc.,SAN,"San Diego, CA: San Diego International",619,135,484
2017,2,2017-02,AS,Alaska Airlines Inc.,SAN,"San Diego, CA: San Diego International",436,115,321
2017,2,2017-02,B6,JetBlue Airways,SAN,"San Diego, CA: San Diego International",124,37,87
2017,2,2017-02,DL,Delta Air Lines Inc.,SAN,"San Diego, CA: San Diego International",476,78,398
2017,2,2017-02,WN,Southwest Airlines Co.,SAN,"San Diego, CA: San Diego International",2515,606,1909
